Assembly	[C]omplete BUSCOs	Complete and [S]ingle-copy BUSCOs	Complete and [D]uplicated BUSCOs	[F]ragmented BUSCOs	[M]issing BUSCOs	Name
GCA_000002515.1	1610	1607	3	6	90	Kluyveromyces lactis NRRL Y-1140
GCA_000002525.1	1583	1575	8	5	118	Yarrowia lipolytica CLIB122 CLIB122
GCA_000002545.2	1601	1563	38	4	101	[Candida] glabrata CBS 138
GCA_000003835.1	1564	1561	3	18	124	Clavispora lusitaniae ATCC 42720 ATCC 42720
GCA_000006335.3	1593	1582	11	9	104	Candida tropicalis MYA-3404 MYA-3404
GCA_000006445.2	1667	1664	3	2	37	Debaryomyces hansenii CBS767 CBS767
GCA_000026365.1	1631	1628	3	4	71	Zygosaccharomyces rouxii CBS 732
GCA_000026945.1	1615	1607	8	4	87	Candida dubliniensis CD36 CD36
GCA_000027005.1	1594	1590	4	9	103	Komagataella phaffii GS115 GS115
GCA_000091025.4	1581	1579	2	11	114	Eremothecium gossypii ATCC 10895 ATCC 10895
GCA_000142805.1	1638	1637	1	7	61	Lachancea thermotolerans CBS 6340 CBS 6340
GCA_000146045.2	1627	1544	83	5	74	Saccharomyces cerevisiae S288C S288C
GCA_000147375.2	1467	199	1268	84	155	Wickerhamomyces anomalus NRRL Y-366 NRRL Y-366
GCA_000149225.1	1658	1649	9	5	43	Lachancea kluyveri NRRL Y-12651 NRRL Y-12651
GCA_000149365.1	1612	1534	78	6	88	Saccharomyces cerevisiae RM11-1a RM11-1a
GCA_000149425.1	1598	1595	3	14	94	Meyerozyma guilliermondii ATCC 6260 ATCC 6260
GCA_000149445.2	1594	1584	10	7	105	Candida albicans WO-1 WO-1
GCA_000149685.1	1549	1544	5	14	143	Lodderomyces elongisporus NRRL YB-4239 NRRL YB-4239
GCA_000150035.1	1588	1513	75	8	110	Vanderwaltozyma polyspora DSM 70294 DSM 70294
GCA_000151485.1	1622	1543	79	5	79	Saccharomyces cerevisiae Sigma1278b Sigma1278b
GCA_000166955.1	1575	1498	77	20	111	Saccharomyces paradoxus NRRL Y-17217 NRRL Y-17217
GCA_000166975.1	1429	1369	60	79	198	Saccharomyces mikatae IFO 1815 IFO 1815
GCA_000166995.1	1463	1392	71	51	192	Saccharomyces uvarum CLIB 533 MCYC 623
GCA_000167015.1	1552	1472	80	24	130	Naumovozyma castellii NRRL Y-12630 NRRL Y-12630
GCA_000167035.1	1571	1488	83	23	112	Saccharomyces uvarum CLIB 533 623-6C
GCA_000167055.1	1016	966	50	240	450	Saccharomyces mikatae IFO 1815 IFO 1815
GCA_000167075.2	1197	1149	48	171	338	Saccharomyces kudriavzevii IFO 1802 IFO 1802
GCA_000167115.1	1582	1574	8	18	106	Lachancea waltii NCYC 2644 NCYC 2644
GCA_000179355.1	1576	1576	0	15	115	Kluyveromyces aestuarii ATCC 18862 ATCC 18862
GCA_000179415.1	1553	1553	0	34	119	Kluyveromyces wickerhamii UCD 54-210 UCD 54-210
GCA_000181435.1	1620	1538	82	5	81	Saccharomyces cerevisiae YJM789 YJM789
GCA_000182075.2	1545	1477	68	15	146	Saccharomyces cerevisiae M22 M22
GCA_000182095.2	1584	1515	69	10	112	Saccharomyces cerevisiae YPS163 YPS163
GCA_000182115.1	1606	650	956	19	81	Saccharomyces pastorianus Weihenstephan 34/70 Weihenstephan 34/70
GCA_000182175.1	1309	1268	41	131	266	Saccharomyces cerevisiae AWRI1631 AWRI1631
GCA_000182315.2	1625	1550	75	6	75	Saccharomyces cerevisiae JAY291 JAY291
GCA_000182765.2	1607	1600	7	4	95	Candida parapsilosis CDC317
GCA_000182785.1	1580	1573	7	9	117	Komagataella pastoris DSMZ 70382 DSMZ 70382
GCA_000182965.3	1618	1609	9	4	84	Candida albicans SC5314 SC5314
GCA_000187245.3	1565	1563	2	7	134	Ogataea parapolymorpha DL-1 DL-1
GCA_000190195.1	1361	1303	58	48	297	Saccharomyces cerevisiae AWRI796 AWRI796
GCA_000190215.1	1433	1376	57	37	236	Saccharomyces cerevisiae Vin13 Vin13
GCA_000190235.1	1425	1369	56	37	244	Saccharomyces cerevisiae VL3 VL3
GCA_000190255.1	1354	1300	54	55	297	Saccharomyces cerevisiae FostersB FostersB
GCA_000192375.1	854	830	24	211	641	Saccharomyces cerevisiae Y10 Y10
GCA_000192455.1	1440	1368	72	56	210	Saccharomyces cerevisiae CBS 7960 CBS 7960
GCA_000192495.1	1096	1054	42	135	475	Saccharomyces cerevisiae CLIB324 CLIB324
GCA_000192515.1	1460	1394	66	47	199	Saccharomyces cerevisiae YJM269 YJM269
GCA_000192535.1	1167	1110	57	120	419	Saccharomyces cerevisiae FL100 FL100
GCA_000192555.1	1367	1308	59	66	273	Saccharomyces cerevisiae CLIB215 CLIB215
GCA_000209165.1	1648	1645	3	2	56	Scheffersomyces stipitis CBS 6054 CBS 6054
GCA_000209265.1	1576	1508	68	21	109	Saccharomyces cerevisiae PW5 PW5
GCA_000209285.1	1574	1511	63	21	111	Saccharomyces cerevisiae UC5 UC5
GCA_000209305.1	1161	1129	32	144	401	Saccharomyces cerevisiae T73 T73
GCA_000209345.1	305	305	0	398	1003	Saccharomyces cerevisiae CLIB382 CLIB382
GCA_000209365.1	1628	1544	84	5	73	Saccharomyces cerevisiae T7 T7
GCA_000218975.1	1623	1538	85	7	76	Saccharomyces cerevisiae EC1118 Lalvin EC1118
GCA_000223465.1	1609	1606	3	2	95	Yamadazyma tenuis ATCC 10573 ATCC 10573
GCA_000223485.1	1627	1623	4	2	77	Spathaspora passalidarum NRRL Y-27907 NRRL Y-27907
GCA_000223565.1	1598	1592	6	10	98	Komagataella phaffii CBS 7435 CBS 7435
GCA_000227115.2	1608	1549	59	4	94	Naumovozyma dairenensis CBS 421 type strain:CBS 421
GCA_000234495.1	1506	1446	60	19	181	Saccharomyces cerevisiae EC9-8 EC9-8
GCA_000235365.1	1581	1581	0	12	113	Eremothecium cymbalariae DBVPG#7215 DBVPG#7215
GCA_000236905.1	1594	1540	54	4	108	Tetrapisispora phaffii CBS 4417 type strain:CBS 4417
GCA_000237345.1	1618	1530	88	0	88	Naumovozyma castellii CBS 4309 type strain:CBS 4309
GCA_000239015.2	1662	1657	5	2	42	Debaryomyces hansenii var. hansenii MTCC 234 MTCC 234
GCA_000243375.1	1634	1632	2	4	68	Torulaspora delbrueckii type strain:CBS 1146
GCA_000256055.1	580	572	8	184	942	Saccharomyces kudriavzevii FM1056 FM1056
GCA_000256805.1	64	64	0	193	1449	Saccharomyces kudriavzevii FM1073 FM1073
GCA_000256825.1	347	345	2	287	1072	Saccharomyces kudriavzevii FM1071 FM1071
GCA_000256845.1	426	422	4	246	1034	Saccharomyces kudriavzevii FM1072 FM1072
GCA_000256865.1	685	675	10	236	785	Saccharomyces kudriavzevii FM1069 FM1069
GCA_000256885.1	429	427	2	261	1016	Saccharomyces kudriavzevii FM1076 FM1076
GCA_000256905.1	145	145	0	196	1365	Saccharomyces kudriavzevii FM1075 FM1075
GCA_000256925.1	135	132	3	236	1335	Saccharomyces kudriavzevii FM1074 FM1074
GCA_000256985.1	586	578	8	271	849	Saccharomyces kudriavzevii FM1077 FM1077
GCA_000257005.1	480	477	3	296	930	Saccharomyces kudriavzevii FM1078 FM1078
GCA_000257025.1	248	245	3	289	1169	Saccharomyces kudriavzevii FM1079 FM1079
GCA_000257045.1	1181	1139	42	169	356	Saccharomyces kudriavzevii ZP591 ZP591
GCA_000257065.1	1118	1088	30	183	405	Saccharomyces kudriavzevii IFO1803 IFO1803
GCA_000257085.1	776	760	16	236	694	Saccharomyces kudriavzevii IFO10991 IFO10991
GCA_000257105.1	872	850	22	231	603	Saccharomyces kudriavzevii IFO10990 IFO10990
GCA_000259595.1	775	772	3	170	761	Brettanomyces bruxellensis AWRI1499 AWRI1499
GCA_000260735.1	1622	1540	82	4	80	Saccharomyces cerevisiae Kyokai no. 7 Kyokai no. 7
GCA_000269885.1	1625	1546	79	5	76	Saccharomyces cerevisiae CEN.PK113-7D CEN.PK113-7D
GCA_000275665.1	1627	1544	83	3	76	Saccharomyces cerevisiae YJSH1 YJSH1
GCA_000286515.1	1410	1407	3	20	276	Pichia kudriavzevii M12 M12
GCA_000287895.1	1637	247	1390	7	62	Saccharomyces pastorianus CCY48 - 91 CCY48 - 91
GCA_000292725.1	1611	1538	73	5	90	Saccharomyces arboricola H-6 H-6
GCA_000292815.1	1614	1533	81	7	85	Saccharomyces cerevisiae W303 W303
GCA_000299195.2	1612	1610	2	9	85	Kluyveromyces marxianus var. marxianus KCTC 17555 KCTC 17555
GCA_000304155.1	1405	1353	52	108	193	Candida orthopsilosis AY2 AY2
GCA_000304475.1	1587	1536	51	5	114	Kazachstania africana CBS 2517 type strain:CBS 2517
GCA_000308935.1	1619	1539	80	8	79	Saccharomyces cerevisiae ZTW1 ZTW1
GCA_000313485.1	1647	1643	4	4	55	Wickerhamomyces ciferrii NRRL Y-1031 F-60-10
GCA_000313505.1	1625	1619	6	6	75	Pachysolen tannophilus NRRL Y-2460 NRRL Y-2460
GCA_000315875.1	1609	1607	2	4	93	Candida orthopsilosis Co 90-125 Co 90-125
GCA_000315915.1	1534	1494	40	7	165	Tetrapisispora blattae CBS 6284 type strain:CBS 6284
GCA_000317355.2	1486	629	857	34	186	Metschnikowia fructicola 277 277
GCA_000325965.1	1425	1370	55	42	239	Saccharomyces cerevisiae Lalvin QA23 Lalvin QA23
GCA_000326005.1	1276	1218	58	60	370	Saccharomyces cerevisiae FostersO FostersO
GCA_000326105.1	1625	429	1196	7	74	Saccharomyces cerevisiae x Saccharomyces kudriavzevii VIN7 VIN7
GCA_000328385.1	1584	1557	27	14	108	Cyberlindnera jadinii NBRC 0988 NBRC0988
GCA_000340765.1	1453	1428	25	18	235	Brettanomyces bruxellensis CBS 2499 CBS 2499
GCA_000344705.1	1600	1597	3	9	97	Candida maltosa Xu316
GCA_000348985.1	1570	1517	53	7	129	Kazachstania naganishii CBS 8797 type strain:CBS 8797
GCA_000365045.1	1631	1548	83	2	73	Saccharomyces cerevisiae M3707 M3707
GCA_000365065.1	1629	1543	86	2	75	Saccharomyces cerevisiae M3836 M3836
GCA_000365085.1	1631	1548	83	2	73	Saccharomyces cerevisiae M3837 M3837
GCA_000365105.1	1632	1547	85	2	72	Saccharomyces cerevisiae M3838 M3838
GCA_000365125.1	1629	1545	84	2	75	Saccharomyces cerevisiae M3839 M3839
GCA_000410855.1	1593	1591	2	15	98	Clavispora lusitaniae MTCC 1001 MTCC 1001
GCA_000412225.2	1587	1584	3	11	108	Saccharomycetaceae sp. 'Ashbya aceri'
GCA_000416405.1	1630	1545	85	3	73	Saccharomyces cerevisiae NY1308 NY1308
GCA_000442675.2	1625	1540	85	7	74	Saccharomyces sp. EDRL EDRL
GCA_000442885.1	1635	1632	3	8	63	Zygosaccharomyces bailii CLIB 213 CLIB 213 = CBS 680
GCA_000447455.1	1611	1581	30	4	91	Candida albicans A123 A123
GCA_000447475.1	1614	1587	27	3	89	Candida albicans A92 A92
GCA_000447495.1	1616	1594	22	3	87	Candida albicans A203 A203
GCA_000447515.1	1614	1595	19	3	89	Candida albicans A67 A67
GCA_000447535.1	1612	1576	36	5	89	Candida albicans A48 A48
GCA_000447555.1	1610	1584	26	7	89	Candida albicans CHN1 CHN1
GCA_000447575.1	1616	1591	25	3	87	Candida albicans A20 A20
GCA_000447595.1	1616	1584	32	3	87	Candida albicans 3153A 3153A
GCA_000447615.1	1612	1588	24	4	90	Candida albicans A155 A155
GCA_000447635.1	1614	1587	27	5	87	Candida albicans A84 A84
GCA_000497105.2	1599	1562	37	6	101	[Candida] glabrata CCTCC M202019 CCTCC M202019
GCA_000497715.1	1617	1615	2	3	86	Spathaspora arborariae UFMG-19.1A UFMG-19.1A
GCA_000508805.2	1624	1543	81	6	76	Saccharomyces cerevisiae NAM34-4C NAM34-4C
GCA_000508825.2	1612	1533	79	4	90	Saccharomyces cerevisiae IR-2 IR-2
GCA_000568005.1	1605	1526	79	8	93	Saccharomyces cerevisiae R008 R008
GCA_000568055.1	1557	1485	72	11	138	Saccharomyces cerevisiae P301 P301
GCA_000568295.1	1589	1516	73	11	106	Saccharomyces cerevisiae P283 P283
GCA_000568365.1	1587	1516	71	12	107	Saccharomyces cerevisiae R103 R103
GCA_000576695.1	1604	1601	3	6	96	Kuraishia capsulata CBS 1993 CBS 1993
GCA_000585475.3	1441	1439	2	7	258	Hanseniaspora vineae T02/19AF
GCA_000586535.1	1628	277	1351	9	69	Saccharomyces pastorianus Weihenstephan 34/70 Weihenstephan 34/70
GCA_000586595.1	1624	581	1043	5	77	Saccharomyces pastorianus CBS 1513 CBS 1513
GCA_000590845.2	1566	1560	6	5	135	Yarrowia lipolytica PO1f PO1f
GCA_000613145.2	1582	1575	7	5	119	Yarrowia lipolytica WSH-Z06 WSH-Z06
GCA_000633855.1	1614	1580	34	3	89	Candida tropicalis 121
GCA_000647555.1	1612	1603	9	7	87	Candida dubliniensis UOB319
GCA_000647575.1	1612	1605	7	6	88	Candida dubliniensis UOB320
GCA_000662435.2	1627	1543	84	5	74	Saccharomyces cerevisiae YJM993 YJM993
GCA_000691765.2	1601	1592	9	3	102	Candida albicans Ca529L Ca529L
GCA_000710315.1	1578	1578	0	7	121	Eremothecium coryli CBS 5749 CBS 5749
GCA_000723645.1	1627	1549	78	5	74	Saccharomyces cerevisiae N85 N85
GCA_000732305.1	1311	1275	36	95	300	Saccharomyces uvarum A9
GCA_000733235.3	1622	1541	81	11	73	Saccharomyces cerevisiae UFMG A-905 UFMG A-905
GCA_000734875.3	1618	1507	111	5	83	Saccharomyces sp. 'boulardii' 17
GCA_000747785.1	1618	1615	3	8	80	Kluyveromyces marxianus DMB1
GCA_000755205.1	1629	1626	3	10	67	Meyerozyma caribbica MG20W MG20W
GCA_000756235.1	1314	1284	30	170	222	Saccharomyces cerevisiae UCD51
GCA_000756245.1	1172	1144	28	243	291	Saccharomyces cerevisiae M5 M5
GCA_000764455.1	1351	1293	58	42	313	Pichia kudriavzevii SD108
GCA_000766165.2	1618	1519	99	10	78	Saccharomyces cerevisiae YS9
GCA_000766175.2	1633	1536	97	5	68	Saccharomyces cerevisiae YPS163
GCA_000766185.2	1633	1544	89	4	69	Saccharomyces cerevisiae YJM339
GCA_000766195.2	1633	1552	81	4	69	Saccharomyces cerevisiae YPS128
GCA_000766245.2	1632	1562	70	6	68	Saccharomyces cerevisiae Y55
GCA_000766265.2	1629	1566	63	9	68	Saccharomyces cerevisiae g833-1B
GCA_000766275.2	1629	1538	91	5	72	Saccharomyces cerevisiae DBVPG6044
GCA_000766305.2	1606	1511	95	18	82	Saccharomyces cerevisiae RedStar
GCA_000766315.2	1629	1546	83	6	71	Saccharomyces cerevisiae BC187
GCA_000766375.2	1630	1554	76	5	71	Saccharomyces cerevisiae YPH499
GCA_000766395.2	1620	1550	70	10	76	Saccharomyces cerevisiae FY1679
GCA_000766415.2	1624	1556	68	9	73	Saccharomyces cerevisiae 10560-6B
GCA_000766435.2	1623	1557	66	9	74	Saccharomyces cerevisiae BY4742
GCA_000766455.2	1618	1550	68	14	74	Saccharomyces cerevisiae JK9-3d
GCA_000766475.2	1624	1552	72	8	74	Saccharomyces cerevisiae W303
GCA_000766495.2	1630	1562	68	8	68	Saccharomyces cerevisiae CEN.PK2-1Ca
GCA_000766515.2	1620	1552	68	11	75	Saccharomyces cerevisiae FL100
GCA_000766535.2	1625	1556	69	10	71	Saccharomyces cerevisiae X2180-1A
GCA_000766555.2	1626	1556	70	10	70	Saccharomyces cerevisiae D273-10B
GCA_000766575.2	1623	1554	69	9	74	Saccharomyces cerevisiae BY4741
GCA_000766595.2	1625	1554	71	6	75	Saccharomyces cerevisiae SEY6210
GCA_000766615.2	1630	1539	91	6	70	Saccharomyces cerevisiae L1528
GCA_000766635.2	1618	1550	68	10	78	Saccharomyces cerevisiae RM11-1A
GCA_000767965.1	1631	1550	81	5	70	Saccharomyces cerevisiae K11
GCA_000768095.1	1591	1505	86	20	95	Saccharomyces cerevisiae UWOPS05_217_3
GCA_000769245.1	1626	1543	83	7	73	Saccharomyces sp. 'boulardii' ATCC MYA-796
GCA_000773725.1	1616	1597	19	5	85	Candida albicans P78048 P78048
GCA_000773735.1	1613	1587	26	3	90	Candida albicans GC75 GC75
GCA_000773745.1	1612	1593	19	7	87	Candida albicans P37005 P37005
GCA_000773755.1	1610	1598	12	5	91	Candida albicans P94015 P94015
GCA_000773805.1	1609	1594	15	7	90	Candida albicans P57072 P57072
GCA_000773825.1	1612	1595	17	4	90	Candida albicans P37037 P37037
GCA_000773845.1	1616	1601	15	7	83	Candida albicans 12C 12C
GCA_000773925.1	1628	1542	86	4	74	Saccharomyces cerevisiae 9464
GCA_000774085.1	1619	1600	19	2	85	Candida albicans P87 P87
GCA_000775265.3	972	969	3	29	705	Hanseniaspora uvarum 34-9
GCA_000775445.1	1624	1605	19	1	81	Candida albicans 19F 19F
GCA_000775455.1	1618	1601	17	3	85	Candida albicans L26 L26
GCA_000775465.1	1608	1592	16	2	96	Candida albicans P34048 P34048
GCA_000775505.1	1613	1600	13	4	89	Candida albicans P57055 P57055
GCA_000775525.1	1617	1608	9	3	86	Candida albicans P75063 P75063
GCA_000775555.1	1625	1548	77	7	74	Saccharomyces cerevisiae EBY.VW4000
GCA_000784495.1	1612	1600	12	3	91	Candida albicans P76067 P76067
GCA_000784505.1	1610	1600	10	5	91	Candida albicans P76055 P76055
GCA_000784515.1	1617	1596	21	4	85	Candida albicans P37039 P37039
GCA_000784525.1	1608	1590	18	4	94	Candida albicans P60002 P60002
GCA_000784575.1	1611	1599	12	2	93	Candida albicans P75010 P75010
GCA_000784595.1	1606	1594	12	5	95	Candida albicans P75016 P75016
GCA_000784615.1	1611	1586	25	4	91	Candida albicans P78042 P78042
GCA_000784635.1	1616	1579	37	4	86	Candida albicans SC5314 SC5314
GCA_000784655.1	1616	1576	40	3	87	Candida albicans SC5314 SC5314
GCA_000784695.1	1609	1585	24	3	94	Candida albicans Ca6 Ca6
GCA_000787595.2	1566	1563	3	6	134	Ogataea polymorpha BY4329
GCA_000787615.1	1377	1375	2	25	304	Pichia kudriavzevii NBRC 1279
GCA_000805465.1	1633	229	1404	7	66	Saccharomyces pastorianus CBS 1483
GCA_000817185.1	1518	1507	11	13	175	Magnusiomyces capitatus CNRMA 12.647 CNRMA 12.647
GCA_000820885.1	1608	1605	3	8	90	Kluyveromyces dobzhanskii CBS 2104 CBS 2104
GCA_000938715.1	1638	1637	1	7	61	Lachancea lanzarotensis CBS 12615
GCA_000950655.1	1180	1178	2	36	490	Starmerella bombicola NBRC 10243
GCA_000968475.1	995	983	12	15	696	Hanseniaspora uvarum DSM 2768 DSM 2768
GCA_000968835.1	1585	1583	2	10	111	Eremothecium gossypii FDAG1 FDAG1
GCA_000975585.2	1631	1549	82	3	72	Saccharomyces cerevisiae YJM195 YJM195
GCA_000975615.2	1612	1528	84	4	90	Saccharomyces cerevisiae YJM244 YJM244
GCA_000975645.3	1629	1544	85	5	72	Saccharomyces cerevisiae YJM1078 YJM1078
GCA_000975675.2	1629	1547	82	5	72	Saccharomyces cerevisiae YJM1083 YJM1083
GCA_000975705.2	1627	1543	84	5	74	Saccharomyces cerevisiae YJM1129 YJM1129
GCA_000975735.4	1627	1541	86	5	74	Saccharomyces cerevisiae YJM189 YJM189
GCA_000975765.2	1630	1547	83	5	71	Saccharomyces cerevisiae YJM193 YJM193
GCA_000975795.2	1628	1542	86	5	73	Saccharomyces cerevisiae YJM248 YJM248
GCA_000975825.2	1630	1547	83	5	71	Saccharomyces cerevisiae YJM270 YJM270
GCA_000975855.3	1615	1531	84	6	85	Saccharomyces cerevisiae YJM271 YJM271
GCA_000975885.2	1629	1546	83	3	74	Saccharomyces cerevisiae YJM320 YJM320
GCA_000975915.2	1629	1544	85	4	73	Saccharomyces cerevisiae YJM326 YJM326
GCA_000975945.2	1624	1535	89	5	77	Saccharomyces cerevisiae YJM428 YJM428
GCA_000975975.3	1629	1546	83	4	73	Saccharomyces cerevisiae YJM450 YJM450
GCA_000976005.2	1611	1529	82	4	91	Saccharomyces cerevisiae YJM451 YJM451
GCA_000976035.2	1624	1534	90	7	75	Saccharomyces cerevisiae YJM453 YJM453
GCA_000976065.2	1632	1540	92	2	72	Saccharomyces cerevisiae YJM456 YJM456
GCA_000976095.2	1627	1544	83	5	74	Saccharomyces cerevisiae YJM470 YJM470
GCA_000976125.2	1626	1541	85	4	76	Saccharomyces cerevisiae YJM541 YJM541
GCA_000976155.4	1629	1544	85	3	74	Saccharomyces cerevisiae YJM554 YJM554
GCA_000976185.2	1625	1543	82	6	75	Saccharomyces cerevisiae YJM555 YJM555
GCA_000976215.2	1627	1544	83	4	75	Saccharomyces cerevisiae YJM627 YJM627
GCA_000976245.2	1630	1540	90	4	72	Saccharomyces cerevisiae YJM681 YJM681
GCA_000976275.4	1629	1547	82	4	73	Saccharomyces cerevisiae YJM682 YJM682
GCA_000976305.2	1630	1548	82	2	74	Saccharomyces cerevisiae YJM683 YJM683
GCA_000976335.2	1625	1542	83	4	77	Saccharomyces cerevisiae YJM689 YJM689
GCA_000976365.2	1631	1546	85	4	71	Saccharomyces cerevisiae YJM693 YJM693
GCA_000976395.2	1629	1540	89	4	73	Saccharomyces cerevisiae YJM969 YJM969
GCA_000976425.2	1627	1543	84	5	74	Saccharomyces cerevisiae YJM972 YJM972
GCA_000976455.3	1628	1544	84	5	73	Saccharomyces cerevisiae YJM975 YJM975
GCA_000976485.2	1626	1541	85	5	75	Saccharomyces cerevisiae YJM978 YJM978
GCA_000976515.2	1629	1545	84	5	72	Saccharomyces cerevisiae YJM981 YJM981
GCA_000976545.2	1635	1552	83	3	68	Saccharomyces cerevisiae YJM984 YJM984
GCA_000976575.4	1626	1542	84	5	75	Saccharomyces cerevisiae YJM987 YJM987
GCA_000976605.3	1597	1518	79	4	105	Saccharomyces cerevisiae YJM990 YJM990
GCA_000976665.2	1626	1542	84	5	75	Saccharomyces cerevisiae YJM996 YJM996
GCA_000976695.3	1592	1510	82	3	111	Saccharomyces cerevisiae YJM1133 YJM1133
GCA_000976725.3	1628	1546	82	4	74	Saccharomyces cerevisiae YJM1190 YJM1190
GCA_000976755.2	1629	1546	83	5	72	Saccharomyces cerevisiae YJM1199 YJM1199
GCA_000976785.2	1628	1540	88	5	73	Saccharomyces cerevisiae YJM1202 YJM1202
GCA_000976815.3	1629	1545	84	3	74	Saccharomyces cerevisiae YJM1208 YJM1208
GCA_000976845.3	1626	1541	85	6	74	Saccharomyces cerevisiae YJM1242 YJM1242
GCA_000976875.3	1619	1537	82	7	80	Saccharomyces cerevisiae YJM1244 YJM1244
GCA_000976905.2	1621	1542	79	3	82	Saccharomyces cerevisiae YJM1248 YJM1248
GCA_000976935.2	1633	1533	100	3	70	Saccharomyces cerevisiae YJM1250 YJM1250
GCA_000976965.3	1627	1543	84	5	74	Saccharomyces cerevisiae YJM1252 YJM1252
GCA_000976995.2	1630	1546	84	4	72	Saccharomyces cerevisiae YJM1273 YJM1273
GCA_000977025.2	1627	1540	87	2	77	Saccharomyces cerevisiae YJM1304 YJM1304
GCA_000977055.3	1626	1544	82	6	74	Saccharomyces cerevisiae YJM1307 YJM1307
GCA_000977085.2	1630	1546	84	3	73	Saccharomyces cerevisiae YJM1311 YJM1311
GCA_000977115.3	1630	1547	83	4	72	Saccharomyces cerevisiae YJM1326 YJM1326
GCA_000977145.2	1627	1543	84	5	74	Saccharomyces cerevisiae YJM1332 YJM1332
GCA_000977175.3	1630	1539	91	4	72	Saccharomyces cerevisiae YJM1336 YJM1336
GCA_000977205.2	1629	1545	84	4	73	Saccharomyces cerevisiae YJM1338 YJM1338
GCA_000977235.2	1628	1543	85	6	72	Saccharomyces cerevisiae YJM1341 YJM1341
GCA_000977265.3	1627	1545	82	4	75	Saccharomyces cerevisiae YJM1342 YJM1342
GCA_000977295.2	1627	1526	101	5	74	Saccharomyces cerevisiae YJM1355 YJM1355
GCA_000977325.2	1629	1545	84	4	73	Saccharomyces cerevisiae YJM1356 YJM1356
GCA_000977355.3	1630	1546	84	3	73	Saccharomyces cerevisiae YJM1381 YJM1381
GCA_000977385.2	1629	1545	84	5	72	Saccharomyces cerevisiae YJM1383 YJM1383
GCA_000977415.2	1630	1545	85	2	74	Saccharomyces cerevisiae YJM1385 YJM1385
GCA_000977445.2	1628	1541	87	4	74	Saccharomyces cerevisiae YJM1386 YJM1386
GCA_000977475.3	1626	1541	85	6	74	Saccharomyces cerevisiae YJM1387 YJM1387
GCA_000977505.2	1627	1546	81	5	74	Saccharomyces cerevisiae YJM1388 YJM1388
GCA_000977535.2	1630	1546	84	3	73	Saccharomyces cerevisiae YJM1389 YJM1389
GCA_000977565.2	1630	1531	99	5	71	Saccharomyces cerevisiae YJM1399 YJM1399
GCA_000977595.2	1629	1544	85	3	74	Saccharomyces cerevisiae YJM1400 YJM1400
GCA_000977625.2	1630	1547	83	4	72	Saccharomyces cerevisiae YJM1401 YJM1401
GCA_000977655.2	1628	1544	84	4	74	Saccharomyces cerevisiae YJM1402 YJM1402
GCA_000977685.2	1626	1542	84	6	74	Saccharomyces cerevisiae YJM1415 YJM1415
GCA_000977715.4	1628	1544	84	5	73	Saccharomyces cerevisiae YJM1417 YJM1417
GCA_000977745.2	1631	1547	84	3	72	Saccharomyces cerevisiae YJM1418 YJM1418
GCA_000977775.3	1628	1547	81	4	74	Saccharomyces cerevisiae YJM1419 YJM1419
GCA_000977805.2	1623	1540	83	6	77	Saccharomyces cerevisiae YJM1433 YJM1433
GCA_000977835.2	1630	1545	85	4	72	Saccharomyces cerevisiae YJM1434 YJM1434
GCA_000977865.2	1628	1546	82	3	75	Saccharomyces cerevisiae YJM1439 YJM1439
GCA_000977895.2	1596	1519	77	7	103	Saccharomyces cerevisiae YJM1443 YJM1443
GCA_000977925.2	1612	1531	81	5	89	Saccharomyces cerevisiae YJM1444 YJM1444
GCA_000977955.2	1621	1540	81	8	77	Saccharomyces cerevisiae YJM1447 YJM1447
GCA_000977985.2	1605	1521	84	6	95	Saccharomyces cerevisiae YJM1450 YJM1450
GCA_000978015.2	1614	1531	83	4	88	Saccharomyces cerevisiae YJM1460 YJM1460
GCA_000978045.2	1630	1548	82	5	71	Saccharomyces cerevisiae YJM1463 YJM1463
GCA_000978075.3	1627	1542	85	5	74	Saccharomyces cerevisiae YJM1477 YJM1477
GCA_000978105.2	1630	1541	89	3	73	Saccharomyces cerevisiae YJM1478 YJM1478
GCA_000978135.2	1629	1545	84	3	74	Saccharomyces cerevisiae YJM1479 YJM1479
GCA_000978165.2	1628	1544	84	4	74	Saccharomyces cerevisiae YJM1526 YJM1526
GCA_000978195.2	1627	1543	84	6	73	Saccharomyces cerevisiae YJM1527 YJM1527
GCA_000978225.2	1627	1544	83	5	74	Saccharomyces cerevisiae YJM1549 YJM1549
GCA_000978255.2	1629	1545	84	4	73	Saccharomyces cerevisiae YJM1573 YJM1573
GCA_000978285.2	1610	1531	79	6	90	Saccharomyces cerevisiae YJM1574 YJM1574
GCA_000978315.2	1625	1541	84	3	78	Saccharomyces cerevisiae YJM1592 YJM1592
GCA_000978345.2	1629	1530	99	3	74	Saccharomyces cerevisiae YJM1615 YJM1615
GCA_000982555.2	1608	1606	2	3	95	Candida parapsilosis CBS6318
GCA_000982675.1	1606	1604	2	3	97	Candida parapsilosis GA1
GCA_001005365.1	1387	1187	200	3	316	Candida sp. LDI48194 LDI48194
GCA_001005415.1	1169	1167	2	36	501	Starmerella apicola NRRL Y-50540
GCA_001005505.1	1462	1457	5	14	230	Brettanomyces anomalus YV396
GCA_001006245.1	1629	1548	81	4	73	Saccharomyces cerevisiae 4124-S60
GCA_001029055.1	1436	1429	7	35	235	Torulaspora delbrueckii NRRL Y-50541
GCA_001029075.1	1603	1526	77	10	93	Saccharomyces cerevisiae NCIM3186
GCA_001029995.1	1591	1517	74	9	106	Saccharomyces cerevisiae GSY2239
GCA_001039675.1	1573	1534	39	11	122	Nakaseomyces delphensis CBS 2170 CBS 2170
GCA_001046915.1	1590	1549	41	6	110	[Candida] nivariensis CBS 9983 CBS 9983
GCA_001046935.1	1499	1480	19	13	194	[Candida] castellii CBS 4332 CBS 4332
GCA_001046975.1	1553	1518	35	6	147	Nakaseomyces bacillisporus CBS 7720 CBS 7720
GCA_001051215.1	1628	1545	83	5	73	Saccharomyces cerevisiae ySR127
GCA_001077315.1	1588	1545	43	8	110	[Candida] bracarensis CBS 10154 CBS 10154
GCA_001078085.1	1609	1534	75	13	84	Saccharomyces cerevisiae ISO12
GCA_001078105.1	1632	1553	79	3	71	Saccharomyces cerevisiae Ethanol Red
GCA_001189475.1	1593	1592	1	8	105	[Candida] auris 6684
GCA_001245095.1	1609	1602	7	8	89	Cyberlindnera jadinii CBS1600
GCA_001282415.1	1608	1548	60	7	91	Saccharomyces cerevisiae NRRL Y-12632 NRRL Y-12632
GCA_001298375.2	1623	1525	98	4	79	Saccharomyces sp. 'boulardii' biocodex
GCA_001298625.1	1626	1543	83	5	75	Saccharomyces eubayanus FM1318
GCA_001305865.1	1627	1534	93	5	74	Saccharomyces cerevisiae W303 W303
GCA_001307795.1	1581	1575	6	7	118	Yarrowia lipolytica W29
GCA_001413975.1	1620	1521	99	9	77	Saccharomyces sp. 'boulardii' unique28
GCA_001417835.1	1616	1614	2	9	81	Kluyveromyces marxianus NBRC 1777
GCA_001417885.1	1616	1614	2	8	82	Kluyveromyces marxianus DMKU3-1042 DMKU3-1042
GCA_001442605.1	1567	1564	3	9	130	[Candida] boidinii GF002
GCA_001442715.1	1331	1298	33	6	369	Candida sojae GF41
GCA_001447935.2	1653	1648	5	7	46	Debaryomyces fabryi CBS 789
GCA_001466335.1	1567	1535	32	8	131	Kluyveromyces marxianus IIPE453
GCA_001466525.1	1603	1517	86	4	99	[Candida] glabrata
GCA_001466535.1	1599	1513	86	6	101	[Candida] glabrata
GCA_001466565.1	1589	1445	144	4	113	[Candida] glabrata
GCA_001466575.1	1597	1502	95	7	102	[Candida] glabrata
GCA_001466635.1	1599	1277	322	5	102	[Candida] glabrata
GCA_001466685.1	1596	1484	112	7	103	[Candida] glabrata
GCA_001483335.1	1632	207	1425	6	68	Saccharomyces pastorianus Hybrid yeast 1
GCA_001483345.1	1633	269	1364	4	69	Saccharomyces pastorianus Hybrid yeast 7
GCA_001515405.2	1628	1545	83	4	74	Saccharomyces eubayanus CBS12357
GCA_001515425.2	1612	841	771	18	76	Saccharomyces pastorianus CBS 1503 CBS1503
GCA_001515445.2	1629	600	1029	5	72	Saccharomyces pastorianus CBS 1513 CBS1513
GCA_001515465.2	1628	1194	434	4	74	Saccharomyces pastorianus CBS1538
GCA_001515485.2	1631	235	1396	9	66	Saccharomyces pastorianus Weihenstephan 34/70 Weihenstephan 34/70
GCA_001545905.1	1630	1541	89	5	71	Saccharomyces sp. 'boulardii' kirkman
GCA_001545975.1	1628	1547	81	6	72	Saccharomyces sp. 'boulardii' Unisankyo
GCA_001578265.1	1601	1542	59	16	89	Saccharomyces cerevisiae 74-D694
GCA_001578275.1	1543	1474	69	24	139	Saccharomyces cerevisiae 15V-P4
GCA_001578285.1	1588	1509	79	7	111	Saccharomyces cerevisiae 1B-D1606
GCA_001578295.1	1557	1485	72	18	131	Saccharomyces cerevisiae 25-25-2V-P3982
GCA_001578385.1	951	906	45	188	567	Saccharomyces cerevisiae 6P-33G-D373
GCA_001584535.1	1584	1510	74	11	111	Saccharomyces cerevisiae MT1
GCA_001592655.1	1620	1528	92	6	80	Saccharomyces cerevisiae BSPX042
GCA_001599075.1	1567	1560	7	9	130	Ambrosiozyma kashinagicola JCM 15019
GCA_001599095.1	1632	1630	2	4	70	Hyphopichia homilentoma JCM 1507
GCA_001599115.1	1318	1314	4	22	366	[Candida] sorboxylosa JCM 1536
GCA_001599135.1	1612	1611	1	2	92	[Candida] intermedia JCM 1607
GCA_001599155.1	1604	1602	2	4	98	Wickerhamia fluorescens JCM 1821
GCA_001599195.1	1639	1634	5	7	60	Cyberlindnera fabianii JCM 3601
GCA_001599215.1	1514	1501	13	10	182	Saccharomycopsis malanga JCM 7620
GCA_001599235.1	1619	1617	2	9	78	Meyerozyma carpophila JCM 9396
GCA_001599255.1	1550	1546	4	5	151	[Candida] succiphila JCM 9445
GCA_001599275.1	1223	1222	1	46	437	Wickerhamiella domercqiae JCM 9478
GCA_001599295.1	1513	1491	22	14	179	Sporopachydermia quercuum JCM 9486
GCA_001599315.1	1192	1190	2	35	479	Starmerella bombicola JCM 9596
GCA_001599335.1	1569	1565	4	11	126	[Candida] boidinii JCM 9604
GCA_001599355.1	1542	1540	2	14	150	Nakazawaea peltata JCM 9829
GCA_001599395.1	1641	1637	4	3	62	Scheffersomyces lignosus JCM 9837
GCA_001599895.1	1616	1616	0	6	84	Priceomyces haplophilus JCM 1635
GCA_001599995.1	1554	1535	19	5	147	Ambrosiozyma monospora JCM 7599
GCA_001600075.1	1582	1575	7	3	121	Yarrowia deformans JCM 1694
GCA_001600195.1	1589	1582	7	8	109	Yarrowia keelungensis JCM 14894
GCA_001600375.1	1267	1261	6	26	413	Wickerhamiella versatilis JCM 5958
GCA_001600515.1	1581	1573	8	8	117	Yarrowia sp. JCM 30694 JCM 30694
GCA_001600535.1	1576	1568	8	7	123	Yarrowia sp. JCM 30696 JCM 30696
GCA_001600675.1	1635	1634	1	2	69	Millerozyma acaciae JCM 10732
GCA_001600695.1	1395	1352	43	10	301	Ascoidea asiatica JCM 7603
GCA_001600755.1	1603	1591	12	4	99	Ogataea methanolica JCM 10240
GCA_001600815.1	1547	1399	148	12	147	Alloascoidea hylecoeti JCM 7604
GCA_001602355.1	1588	1581	7	9	109	Yarrowia sp. JCM 30695 JCM 30695
GCA_001611835.1	1578	1445	133	31	97	Saccharomyces cerevisiae Lalvin L2056 Lalvin L2056
GCA_001625055.1	1628	1548	80	6	72	Saccharomyces sp. 'boulardii' ATCC MYA-797
GCA_001634645.1	1625	1540	85	6	75	Saccharomyces cerevisiae GLBRCY22-3
GCA_001640025.2	1600	1595	5	11	95	Sugiyamaella lignohabitans CBS 10342
GCA_001640265.1	1636	220	1416	5	65	Saccharomyces pastorianus 79
GCA_001649435.1	1307	257	1050	78	321	[Candida] ethanolica M2 M2
GCA_001655755.1	1582	1567	15	19	105	Spathaspora hagerdaliae UFMG-CM-Y303
GCA_001655765.1	1478	1460	18	68	160	Spathaspora gorwiae UFMG-CM-Y312
GCA_001657455.1	1602	1598	4	8	96	Spathaspora girioi UFMG-CM-Y302
GCA_001659765.1	1576	1573	3	9	121	Wickerhamiella versatilis t-1
GCA_001660455.1	1613	1586	27	6	87	Kluyveromyces marxianus
GCA_001661235.1	1474	1472	2	15	217	Pichia membranifaciens NRRL Y-2026 NRRL Y-2026
GCA_001661245.1	1608	1594	14	9	89	Pachysolen tannophilus NRRL Y-2460 NRRL Y-2460
GCA_001661255.1	1628	1622	6	6	72	Wickerhamomyces anomalus NRRL Y-366-8 NRRL Y-366-8
GCA_001661315.1	1604	1534	70	8	94	Nadsonia fulvescens var. elongata DSM 6958 DSM 6958
GCA_001661325.1	1144	1137	7	95	467	Lipomyces starkeyi NRRL Y-11557 NRRL Y-11557
GCA_001661335.1	1618	1613	5	8	80	Babjeviella inositovora NRRL Y-12698 NRRL Y-12698
GCA_001661345.1	1488	1463	25	12	206	Ascoidea rubescens DSM 1968 DSM 1968
GCA_001661395.1	1644	1640	4	4	58	Hyphopichia burtonii NRRL Y-1933 NRRL Y-1933
GCA_001661405.1	1628	1606	22	5	73	Cyberlindnera jadinii NRRL Y-1542 NRRL Y-1542
GCA_001661415.1	1650	1647	3	6	50	Suhomyces tanzawaensis NRRL Y-17324 NRRL Y-17324
GCA_001661425.1	1589	1584	5	4	113	[Candida] arabinofermentans NRRL YB-2248 NRRL YB-2248
GCA_001661475.1	1443	1443	0	18	245	Tortispora caseinolytica NRRL Y-17796 NRRL Y-17796
GCA_001664025.1	937	926	11	62	707	Hanseniaspora valbyensis NRRL Y-1626 NRRL Y-1626
GCA_001664035.1	1568	1564	4	13	125	Metschnikowia bicuspidata var. bicuspidata NRRL YB-4993 NRRL YB-4993
GCA_001664045.1	1567	1564	3	5	134	Ogataea polymorpha NCYC 495 leu1.1
GCA_001669875.1	1628	1546	82	5	73	Saccharomyces cerevisiae HPRMAwf_D10
GCA_001669905.1	1627	1545	82	5	74	Saccharomyces cerevisiae T.52_3C
GCA_001669935.1	1623	1541	82	7	76	Saccharomyces cerevisiae T.52_3A
GCA_001669965.1	1628	1546	82	4	74	Saccharomyces cerevisiae T.52_2H
GCA_001669995.1	1631	1549	82	3	72	Saccharomyces cerevisiae Sol7-2
GCA_001670025.1	1627	1546	81	5	74	Saccharomyces cerevisiae HB_C_TUKITUKI2_4
GCA_001670055.1	1627	1545	82	4	75	Saccharomyces cerevisiae NSERVsf_F8
GCA_001670085.1	1629	1547	82	5	72	Saccharomyces cerevisiae HCNTHsf_F8
GCA_001670115.1	1629	1547	82	5	72	Saccharomyces cerevisiae T78
GCA_001670145.1	1625	1544	81	5	76	Saccharomyces cerevisiae HCNTHsf_C5
GCA_001670175.1	1629	1547	82	5	72	Saccharomyces cerevisiae TNPLST-4-S-2
GCA_001670205.1	1627	1545	82	6	73	Saccharomyces cerevisiae HB_S_GIMBLETTROAD_9
GCA_001670235.1	1626	1546	80	4	76	Saccharomyces cerevisiae T8
GCA_001670265.1	1629	1546	83	5	72	Saccharomyces cerevisiae MTKSKsf_E2
GCA_001670295.1	1627	1545	82	5	74	Saccharomyces cerevisiae CRIRIwf_A11
GCA_001670325.1	1627	1546	81	4	75	Saccharomyces cerevisiae CDRDR_sf_H
GCA_001670355.1	1631	1549	82	3	72	Saccharomyces cerevisiae Soil7-1
GCA_001670385.1	1629	1547	82	5	72	Saccharomyces cerevisiae HPRMTsf_H7
GCA_001670415.1	1630	1548	82	5	71	Saccharomyces cerevisiae WI_S_OAKURA_4
GCA_001670845.1	1626	1545	81	4	76	Saccharomyces cerevisiae HB_S_BILANCHER_12
GCA_001670935.1	1628	1547	81	6	72	Saccharomyces cerevisiae HB_S_GIMBLETTROAD_22
GCA_001670965.1	1628	1545	83	5	73	Saccharomyces cerevisiae HB_C_OMARUNUI_7
GCA_001670995.1	1625	1544	81	7	74	Saccharomyces cerevisiae HB_C_TUKITUKI1_16
GCA_001671025.1	1629	1548	81	4	73	Saccharomyces cerevisiae WI_S_JASA_5
GCA_001671055.1	1626	1546	80	5	75	Saccharomyces cerevisiae T52
GCA_001671085.1	1628	1546	82	4	74	Saccharomyces cerevisiae HB_C_KOROKIPO_3
GCA_001671115.1	1625	1544	81	5	76	Saccharomyces cerevisiae HB_C_OMARUNUI_14
GCA_001671165.1	1629	1547	82	5	72	Saccharomyces cerevisiae HB_C_OMARUNUI_6
GCA_001671195.1	1628	1546	82	4	74	Saccharomyces cerevisiae WA_C_WAITAKEREROAD_7
GCA_001671225.1	1630	1548	82	4	72	Saccharomyces cerevisiae WI_C_MB95MBMZ_4
GCA_001671255.1	1629	1548	81	4	73	Saccharomyces cerevisiae WI_C_MBSP_15
GCA_001671285.1	1629	1548	81	5	72	Saccharomyces cerevisiae WI_C_MBSP_4
GCA_001671315.1	1626	1544	82	5	75	Saccharomyces cerevisiae T.52_5E
GCA_001671345.1	1627	1545	82	5	74	Saccharomyces cerevisiae WA_C_KINGSMILL_10
GCA_001671375.1	1628	1547	81	5	73	Saccharomyces cerevisiae WA_C_MATES_10
GCA_001671405.1	1627	1545	82	5	74	Saccharomyces cerevisiae WSERCsf_G4
GCA_001671435.1	1627	1546	81	6	73	Saccharomyces cerevisiae HB_S_GIMBLETTROAD_5
GCA_001671565.1	1627	1545	82	5	74	Saccharomyces cerevisiae HCNKIsf_G7
GCA_001671595.1	1628	1546	82	3	75	Saccharomyces cerevisiae WSETAwf_B1
GCA_001671625.1	1627	1546	81	4	75	Saccharomyces cerevisiae NSEBRsf_A9
GCA_001671655.1	1625	1545	80	6	75	Saccharomyces cerevisiae MARARsf_A10
GCA_001671685.1	1627	1546	81	5	74	Saccharomyces cerevisiae T16
GCA_001671715.1	1625	1546	79	5	76	Saccharomyces cerevisiae WA_C_CODDINGTON_2
GCA_001671745.1	1628	1546	82	4	74	Saccharomyces cerevisiae T.52_5A
GCA_001671775.1	1628	1547	81	5	73	Saccharomyces cerevisiae WA_C_MATES_13
GCA_001671805.1	1629	1548	81	5	72	Saccharomyces cerevisiae HB_C_KOROKIPO_12
GCA_001671835.1	1626	1544	82	6	74	Saccharomyces cerevisiae WI_S_JASA_13
GCA_001671865.1	1626	1544	82	5	75	Saccharomyces cerevisiae HB_C_TUKITUKI2_10
GCA_001671895.1	1629	1547	82	5	72	Saccharomyces cerevisiae HB_S_GIMBLETTROAD_14
GCA_001671925.1	1628	1546	82	4	74	Saccharomyces cerevisiae T63
GCA_001671955.1	1626	1544	82	5	75	Saccharomyces cerevisiae HB_S_BILANCHER_6
GCA_001671985.1	1626	1545	81	6	74	Saccharomyces cerevisiae HB_S_GIMBLETTROAD_16
GCA_001673695.2	1598	1596	2	9	99	Clavispora lusitaniae CBS 6936
GCA_001682995.1	1661	1656	5	3	42	Debaryomyces hansenii J6
GCA_001692465.1	1608	1607	1	10	88	Kluyveromyces marxianus UFS-Y2791
GCA_001708085.1	1610	1604	6	7	89	Komagataella phaffii
GCA_001708105.1	1606	1599	7	6	94	Komagataella pastoris ATCC 28485
GCA_001719535.1	1327	1325	2	52	327	Brettanomyces bruxellensis CBS 2796
GCA_001735825.1	1627	1547	80	7	72	Saccharomyces cerevisiae wild007
GCA_001737145.2	1625	1545	80	6	75	Saccharomyces cerevisiae wild003
GCA_001737155.1	1627	1545	82	6	73	Saccharomyces cerevisiae wild005
GCA_001737165.1	1629	1550	79	4	73	Saccharomyces cerevisiae wild004
GCA_001737175.1	1627	1545	82	5	74	Saccharomyces cerevisiae wild006
GCA_001737265.1	1628	1547	81	4	74	Saccharomyces cerevisiae wild002
GCA_001737275.1	1632	1550	82	3	71	Saccharomyces cerevisiae wild001
GCA_001737285.1	1629	1547	82	4	73	Saccharomyces cerevisiae wine019
GCA_001737295.2	1630	1549	81	5	71	Saccharomyces cerevisiae wine018
GCA_001737385.2	1627	1548	79	4	75	Saccharomyces cerevisiae wine017
GCA_001737395.2	1628	1548	80	4	74	Saccharomyces cerevisiae wine016
GCA_001737415.2	1629	1548	81	5	72	Saccharomyces cerevisiae wine015
GCA_001737445.2	1627	1548	79	6	73	Saccharomyces cerevisiae wine014
GCA_001737505.2	1626	1545	81	6	74	Saccharomyces cerevisiae wine013
GCA_001737515.2	1624	1543	81	5	77	Saccharomyces cerevisiae wine012
GCA_001737535.2	1628	1548	80	6	72	Saccharomyces cerevisiae wine011
GCA_001737545.2	1627	1546	81	7	72	Saccharomyces cerevisiae wine010
GCA_001737625.2	1627	1547	80	5	74	Saccharomyces cerevisiae wine009
GCA_001737635.2	1614	1537	77	9	83	Saccharomyces cerevisiae wine008
GCA_001737645.2	1628	1546	82	6	72	Saccharomyces cerevisiae wine007
GCA_001737655.2	1627	1546	81	5	74	Saccharomyces cerevisiae wine006
GCA_001737745.2	1627	1547	80	4	75	Saccharomyces cerevisiae wine005
GCA_001737755.2	1627	1546	81	6	73	Saccharomyces cerevisiae wine004
GCA_001737765.2	1632	1552	80	3	71	Saccharomyces cerevisiae wine003
GCA_001737785.2	1631	1549	82	3	72	Saccharomyces cerevisiae wine002
GCA_001737865.2	1626	1544	82	6	74	Saccharomyces cerevisiae wine001
GCA_001737875.1	1628	1547	81	4	74	Saccharomyces cerevisiae spirits011
GCA_001737885.1	1629	1548	81	3	74	Saccharomyces cerevisiae spirits010
GCA_001737895.1	1626	1546	80	5	75	Saccharomyces cerevisiae spirits009
GCA_001737985.1	1629	1546	83	4	73	Saccharomyces cerevisiae spirits008
GCA_001737995.1	1628	1545	83	6	72	Saccharomyces cerevisiae spirits007
GCA_001738005.1	1629	1548	81	5	72	Saccharomyces cerevisiae spirits006
GCA_001738015.1	1622	1543	79	7	77	Saccharomyces cerevisiae spirits005
GCA_001738105.1	1629	1550	79	6	71	Saccharomyces cerevisiae spirits004
GCA_001738115.1	1625	1544	81	7	74	Saccharomyces cerevisiae spirits003
GCA_001738125.1	1627	1545	82	6	73	Saccharomyces cerevisiae spirits002
GCA_001738135.2	1627	1546	81	5	74	Saccharomyces cerevisiae spirits001
GCA_001738225.1	1630	1551	79	3	73	Saccharomyces cerevisiae sake007
GCA_001738235.1	1627	1547	80	2	77	Saccharomyces cerevisiae sake006
GCA_001738255.1	1630	1552	78	2	74	Saccharomyces cerevisiae sake005
GCA_001738265.1	1629	1551	78	3	74	Saccharomyces cerevisiae sake004
GCA_001738345.1	1622	1546	76	3	81	Saccharomyces cerevisiae sake003
GCA_001738355.1	1628	1546	82	5	73	Saccharomyces cerevisiae sake002
GCA_001738375.1	1627	1546	81	3	76	Saccharomyces cerevisiae sake001
GCA_001738395.1	1627	1545	82	5	74	Saccharomyces cerevisiae laboratory002
GCA_001738465.1	1627	1548	79	5	74	Saccharomyces cerevisiae laboratory001
GCA_001738485.1	1622	1540	82	7	77	Saccharomyces cerevisiae bread004
GCA_001738495.1	1624	1542	82	8	74	Saccharomyces cerevisiae bread003
GCA_001738515.1	1627	1546	81	4	75	Saccharomyces cerevisiae bread002
GCA_001738585.1	1626	1545	81	5	75	Saccharomyces cerevisiae bread001
GCA_001738595.1	1627	1547	80	4	75	Saccharomyces cerevisiae bioethanol005
GCA_001738605.1	1630	1549	81	2	74	Saccharomyces cerevisiae bioethanol004
GCA_001738615.1	1628	1548	80	2	76	Saccharomyces cerevisiae bioethanol003
GCA_001738705.1	1630	1552	78	4	72	Saccharomyces cerevisiae bioethanol002
GCA_001738715.1	1630	1549	81	3	73	Saccharomyces cerevisiae bioethanol001
GCA_001738725.1	1626	1546	80	5	75	Saccharomyces cerevisiae beer102
GCA_001738755.1	1631	1550	81	4	71	Saccharomyces cerevisiae beer101
GCA_001738825.1	1628	1546	82	4	74	Saccharomyces cerevisiae beer100
GCA_001738835.1	1622	1539	83	8	76	Saccharomyces cerevisiae beer099
GCA_001738845.1	1628	1546	82	5	73	Saccharomyces cerevisiae beer098
GCA_001738855.1	1627	1534	93	4	75	Saccharomyces cerevisiae beer097
GCA_001738945.1	1627	1532	95	4	75	Saccharomyces cerevisiae beer096
GCA_001738955.1	1627	1534	93	3	76	Saccharomyces cerevisiae beer095
GCA_001738965.1	1627	1544	83	6	73	Saccharomyces cerevisiae beer094
GCA_001738985.1	1628	1547	81	3	75	Saccharomyces cerevisiae beer093
GCA_001739065.1	1629	1550	79	3	74	Saccharomyces cerevisiae beer092
GCA_001739075.1	1631	1550	81	3	72	Saccharomyces cerevisiae beer091
GCA_001739095.1	1626	1542	84	5	75	Saccharomyces cerevisiae beer090
GCA_001739105.1	1627	1546	81	4	75	Saccharomyces cerevisiae beer089
GCA_001739185.1	1628	1545	83	6	72	Saccharomyces cerevisiae beer088
GCA_001739215.1	1630	1549	81	4	72	Saccharomyces cerevisiae beer087
GCA_001739225.1	1629	1545	84	4	73	Saccharomyces cerevisiae beer086
GCA_001739235.1	1625	1542	83	4	77	Saccharomyces cerevisiae beer085
GCA_001739305.1	1629	1551	78	5	72	Saccharomyces cerevisiae beer084
GCA_001739335.1	1630	1551	79	4	72	Saccharomyces cerevisiae beer083
GCA_001739345.1	1626	1545	81	4	76	Saccharomyces cerevisiae beer082
GCA_001739355.1	1628	1546	82	5	73	Saccharomyces cerevisiae beer081
GCA_001739425.1	1629	1548	81	4	73	Saccharomyces cerevisiae beer080
GCA_001739455.1	1628	1545	83	4	74	Saccharomyces cerevisiae beer079
GCA_001739475.1	1625	1544	81	4	77	Saccharomyces cerevisiae beer078
GCA_001739495.1	1624	1543	81	5	77	Saccharomyces cerevisiae beer077
GCA_001739545.1	1627	1546	81	3	76	Saccharomyces cerevisiae beer076
GCA_001739575.1	1623	1542	81	4	79	Saccharomyces cerevisiae beer075
GCA_001739595.1	1625	1546	79	5	76	Saccharomyces cerevisiae beer074
GCA_001739625.1	1629	1549	80	6	71	Saccharomyces cerevisiae beer073
GCA_001739665.1	1626	1547	79	5	75	Saccharomyces cerevisiae beer072
GCA_001739695.1	1625	1546	79	6	75	Saccharomyces cerevisiae beer071
GCA_001739705.1	1628	1547	81	5	73	Saccharomyces cerevisiae beer070
GCA_001739735.1	1624	1543	81	5	77	Saccharomyces cerevisiae beer069
GCA_001739775.1	1622	1540	82	7	77	Saccharomyces cerevisiae beer068
GCA_001739815.1	1623	1545	78	7	76	Saccharomyces cerevisiae beer067
GCA_001739825.1	1625	1543	82	6	75	Saccharomyces cerevisiae beer066
GCA_001739845.1	1621	1541	80	9	76	Saccharomyces cerevisiae beer065
GCA_001739865.1	1625	1545	80	4	77	Saccharomyces cerevisiae beer064
GCA_001739935.1	1629	1550	79	4	73	Saccharomyces cerevisiae beer063
GCA_001739945.1	1631	1551	80	2	73	Saccharomyces cerevisiae beer062
GCA_001739965.1	1625	1547	78	5	76	Saccharomyces cerevisiae beer061
GCA_001739995.1	1625	1543	82	4	77	Saccharomyces cerevisiae beer060
GCA_001740055.1	1628	1545	83	5	73	Saccharomyces cerevisiae beer059
GCA_001740075.1	1623	1543	80	6	77	Saccharomyces cerevisiae beer058
GCA_001740095.1	1626	1545	81	6	74	Saccharomyces cerevisiae beer057
GCA_001740115.1	1626	1545	81	4	76	Saccharomyces cerevisiae beer056
GCA_001740175.1	1624	1542	82	6	76	Saccharomyces cerevisiae beer055
GCA_001740185.1	1629	1548	81	4	73	Saccharomyces cerevisiae beer054
GCA_001740205.1	1626	1546	80	4	76	Saccharomyces cerevisiae beer053
GCA_001740225.1	1628	1534	94	4	74	Saccharomyces cerevisiae beer052
GCA_001740295.1	1623	1544	79	7	76	Saccharomyces cerevisiae beer051
GCA_001740305.1	1626	1545	81	6	74	Saccharomyces cerevisiae beer050
GCA_001740325.1	1627	1545	82	3	76	Saccharomyces cerevisiae beer049
GCA_001740345.1	1631	1549	82	3	72	Saccharomyces cerevisiae beer048
GCA_001740415.1	1629	1549	80	4	73	Saccharomyces cerevisiae beer047
GCA_001740425.1	1633	1553	80	5	68	Saccharomyces cerevisiae beer046
GCA_001740445.1	1628	1546	82	5	73	Saccharomyces cerevisiae beer045
GCA_001740455.1	1621	1542	79	6	79	Saccharomyces cerevisiae beer044
GCA_001740535.1	1625	1544	81	5	76	Saccharomyces cerevisiae beer043
GCA_001740545.1	1624	1544	80	5	77	Saccharomyces cerevisiae beer042
GCA_001740565.1	1626	1547	79	5	75	Saccharomyces cerevisiae beer041
GCA_001740575.1	1626	1544	82	5	75	Saccharomyces cerevisiae beer040
GCA_001740655.1	1628	1547	81	4	74	Saccharomyces cerevisiae beer039
GCA_001740665.1	1627	1546	81	7	72	Saccharomyces cerevisiae beer038
GCA_001740675.1	1627	1546	81	4	75	Saccharomyces cerevisiae beer037
GCA_001740705.1	1627	1547	80	5	74	Saccharomyces cerevisiae beer036
GCA_001740775.1	1622	1542	80	7	77	Saccharomyces cerevisiae beer035
GCA_001740785.1	1629	1549	80	5	72	Saccharomyces cerevisiae beer034
GCA_001740795.1	1627	1545	82	5	74	Saccharomyces cerevisiae beer033
GCA_001740805.1	1632	1549	83	3	71	Saccharomyces cerevisiae beer032
GCA_001740895.1	1626	1547	79	4	76	Saccharomyces cerevisiae beer031
GCA_001740905.1	1627	1545	82	6	73	Saccharomyces cerevisiae beer030
GCA_001740915.1	1625	1545	80	7	74	Saccharomyces cerevisiae beer029
GCA_001740925.1	1621	1539	82	8	77	Saccharomyces cerevisiae beer028
GCA_001741015.1	1628	1545	83	5	73	Saccharomyces cerevisiae beer027
GCA_001741025.1	1624	1547	77	6	76	Saccharomyces cerevisiae beer026
GCA_001741035.1	1627	1546	81	5	74	Saccharomyces cerevisiae beer025
GCA_001741045.1	1624	1542	82	6	76	Saccharomyces cerevisiae beer024
GCA_001741135.1	1626	1545	81	4	76	Saccharomyces cerevisiae beer023
GCA_001741145.1	1628	1548	80	3	75	Saccharomyces cerevisiae beer022
GCA_001741165.1	1630	1546	84	5	71	Saccharomyces cerevisiae beer021
GCA_001741195.1	1627	1546	81	5	74	Saccharomyces cerevisiae beer020
GCA_001741255.1	1625	1545	80	6	75	Saccharomyces cerevisiae beer019
GCA_001741285.1	1627	1547	80	4	75	Saccharomyces cerevisiae beer018
GCA_001741295.1	1627	1546	81	4	75	Saccharomyces cerevisiae beer017
GCA_001741305.1	1623	1543	80	7	76	Saccharomyces cerevisiae beer016
GCA_001741375.1	1625	1544	81	5	76	Saccharomyces cerevisiae beer015
GCA_001741405.1	1629	1548	81	5	72	Saccharomyces cerevisiae beer014
GCA_001741415.1	1631	1551	80	5	70	Saccharomyces cerevisiae beer013
GCA_001741425.1	1630	1550	80	5	71	Saccharomyces cerevisiae beer012
GCA_001741495.1	1629	1548	81	4	73	Saccharomyces cerevisiae beer011
GCA_001741525.1	1627	1546	81	4	75	Saccharomyces cerevisiae beer010
GCA_001741535.1	1625	1544	81	4	77	Saccharomyces cerevisiae beer009
GCA_001741555.1	1625	1546	79	5	76	Saccharomyces cerevisiae beer008
GCA_001741605.1	1624	1543	81	6	76	Saccharomyces cerevisiae beer007
GCA_001741685.1	1622	1541	81	7	77	Saccharomyces cerevisiae beer006
GCA_001741695.1	1622	1541	81	7	77	Saccharomyces cerevisiae beer005
GCA_001741705.1	1627	1545	82	4	75	Saccharomyces cerevisiae beer004
GCA_001741725.1	1629	1549	80	5	72	Saccharomyces cerevisiae beer003
GCA_001741805.1	1628	1548	80	4	74	Saccharomyces cerevisiae beer001
GCA_001741815.1	1632	1553	79	2	72	Saccharomyces cerevisiae beer002
GCA_001746385.1	1453	1448	5	20	233	Brettanomyces custersianus CBS 4805
GCA_001746955.1	1608	1602	6	8	90	Komagataella phaffii GS115 GS115
GCA_001747045.1	1414	1411	3	11	281	Hanseniaspora osmophila AWRI3579
GCA_001747055.1	973	972	1	20	713	Hanseniaspora uvarum AWRI3580
GCA_001749795.1	948	946	2	23	735	Hanseniaspora opuntiae AWRI3578
GCA_001750485.1	1624	1544	80	4	78	Saccharomyces cerevisiae GUJ105
GCA_001754015.1	1467	1463	4	16	223	Brettanomyces anomalus CBS 7654
GCA_001761485.1	1584	1577	7	5	117	Yarrowia lipolytica CLIB89(W29)
GCA_001854445.2	1612	1610	2	10	84	Kluyveromyces marxianus FIM1
GCA_001879685.1	1140	1131	9	141	425	Pichia kudriavzevii KMBL5774
GCA_001932575.1	1634	1541	93	4	68	Saccharomyces cerevisiae BG1
GCA_001936135.1	1547	139	1408	3	156	Saccharomycopsis fibuligera x Saccharomycopsis cf. fibuligera KJJ81
GCA_001936155.1	1525	1503	22	10	171	Saccharomycopsis fibuligera KPH12
GCA_001936275.1	1478	1457	21	9	219	Saccharomycopsis fibuligera ATCC 36309
GCA_001937245.1	1629	1533	96	4	73	Saccharomyces cerevisiae VTT A-81062
GCA_001939105.2	1601	1593	8	11	94	Sugiyamaella xylanicola UFMG-CM-Y1884
GCA_001950435.1	1633	168	1465	5	68	Zygosaccharomyces rouxii NBRC 1876
GCA_001950555.1	1522	1517	5	8	176	Candida sp. JCM 15000 JCM 15000
GCA_001950575.1	1464	1463	1	12	230	Pichia membranifaciens KS47-1
GCA_001972345.1	1639	116	1523	3	64	Zygosaccharomyces rouxii NBRC 110957
GCA_001983305.1	1551	1549	2	16	139	Cyberlindnera fabianii 65
GCA_001983315.1	1515	1437	78	12	179	Saccharomyces cerevisiae 131
GCA_001983325.1	1435	1385	50	12	259	Pichia kudriavzevii 129
GCA_001984395.2	1643	139	1504	5	58	Zygosaccharomyces parabailii ATCC 60483
GCA_002007985.1	1570	1564	6	10	126	[Candida] boidinii Cb18
GCA_002007995.1	1512	1509	3	36	158	[Candida] boidinii TOMC-Y13
GCA_002008015.1	1568	1563	5	13	125	[Candida] boidinii NDK27A1
GCA_002008025.1	1570	1564	6	11	125	[Candida] boidinii UNISS-Cb60
GCA_002008065.1	1535	1531	4	23	148	[Candida] boidinii TOMC-Y47
GCA_002008075.1	1564	1559	5	15	127	[Candida] boidinii DBVPG6799
GCA_002008085.1	1551	1547	4	18	137	[Candida] boidinii DBVPG8035
GCA_002008095.1	1533	1529	4	26	147	[Candida] boidinii DBVPG7578
GCA_002024125.1	1104	1100	4	27	575	Starmerella bacillaris FRI751
GCA_002057635.1	1628	1545	83	5	73	Saccharomyces cerevisiae S288c
GCA_002057805.1	1629	1545	84	6	71	Saccharomyces cerevisiae DBVPG6765
GCA_002057885.1	1629	1548	81	4	73	Saccharomyces cerevisiae SK1
GCA_002057995.1	1633	1550	83	3	70	Saccharomyces cerevisiae YPS128
GCA_002058095.1	1625	1542	83	8	73	Saccharomyces cerevisiae UWOPS03-461.4
GCA_002058645.1	1628	1546	82	4	74	Saccharomyces cerevisiae Y12
GCA_002068075.1	1590	1587	3	6	110	[Candida] aaseri SH-14
GCA_002073855.1	1570	1569	1	10	126	Metschnikowia australis UFMG-CM-Y6158
GCA_002079025.1	1631	1549	82	3	72	Saccharomyces cerevisiae DBVPG6044
GCA_002079055.1	1627	1544	83	4	75	Saccharomyces paradoxus CBS432
GCA_002079085.1	1627	1542	85	4	75	Saccharomyces paradoxus N44
GCA_002079115.1	1624	1540	84	7	75	Saccharomyces paradoxus YPS138
GCA_002079145.1	1624	1543	81	7	75	Saccharomyces paradoxus UFRJ50816
GCA_002079175.1	1622	1539	83	3	81	Saccharomyces paradoxus UWOPS91-917.1
GCA_002094175.1	1108	1105	3	25	573	Starmerella bacillaris PAS13
GCA_002094185.1	1614	1610	4	8	84	Spathaspora boniae UFMG-CM-Y306
GCA_002105455.1	1614	1609	5	6	86	Spathaspora xylofermentans UFMG-HMD23.3
GCA_002109505.1	1598	1596	2	5	103	Yamadazyma laniorum yHMH7
GCA_002118035.1	1647	1643	4	1	58	Scheffersomyces shehatae ATY839
GCA_002118155.1	1647	1645	2	1	58	Scheffersomyces shehatae NBRC 1983
GCA_002141495.2	1435	1431	4	10	261	Hanseniaspora vineae T02/05AF
GCA_002151565.1	1611	1609	2	7	88	Kluyveromyces lactis GG799
GCA_002163515.1	1626	1543	83	5	75	Saccharomyces cerevisiae W303 W303
GCA_002166775.1	1369	1365	4	23	314	Pichia kudriavzevii Ckrusei653
GCA_002196765.1	1628	116	1512	3	75	Millerozyma farinosa KCTC 27753
GCA_002214845.1	1635	1631	4	7	64	Torulaspora delbrueckii SRCM101298
GCA_002214855.1	1599	1518	81	9	98	Saccharomyces cerevisiae SRCM100587
GCA_002214935.1	1521	1481	40	11	174	Kazachstania servazzii SRCM102023
GCA_002219185.1	1600	1564	36	5	101	[Candida] glabrata DSY562
GCA_002219195.1	1600	1564	36	4	102	[Candida] glabrata DSY565
GCA_002233575.1	404	374	30	249	1053	Geotrichum fermentans CICC 1368
GCA_002242635.1	1628	1546	82	7	71	Saccharomyces uvarum U4
GCA_002242645.1	1621	1540	81	9	76	Saccharomyces uvarum U3
GCA_002242675.1	1613	1537	76	7	86	Saccharomyces uvarum U1
GCA_002242715.1	1622	1549	73	7	77	Saccharomyces uvarum U2
GCA_002245345.1	1605	1601	4	6	95	Scheffersomyces stambukii UFMG-CM-Y427
GCA_002250225.1	1626	1550	76	7	73	Saccharomyces cerevisiae SK1
GCA_002251995.2	1425	1419	6	13	268	Wickerhamiella sorbophila DS02
GCA_002259805.1	1481	1422	59	36	189	Candida albicans UAB012-W3D5
GCA_002259835.1	1600	1564	36	3	103	[Candida] glabrata UAB047-W10D4
GCA_002259865.1	1506	1424	82	24	176	Candida albicans UAB090-W2D7
GCA_002259875.1	1544	1469	75	15	147	Candida albicans UAB012-W7D4
GCA_002259885.1	1526	1472	54	22	158	Candida albicans UAB040-W3D3
GCA_002270425.1	1105	1101	4	27	574	Starmerella bacillaris NP2
GCA_002271905.1	1626	1544	82	4	76	Saccharomyces cerevisiae DBVPG6044
GCA_002271945.1	1616	1534	82	5	85	Saccharomyces cerevisiae Y12
GCA_002276455.1	1589	1433	156	9	108	Candida albicans ATCC 10231
GCA_002335645.1	1620	1507	113	5	81	Saccharomyces cerevisiae Kagoshima no. 2
GCA_002356615.1	1615	1613	2	7	84	Kluyveromyces marxianus NRRL Y-6860
GCA_002370125.1	1570	1569	1	12	124	Metschnikowia cubensis MUCL 45751
GCA_002370135.1	1569	1568	1	9	128	Metschnikowia kipukae UWOPS 00-669.2
GCA_002370145.1	1584	1582	2	8	114	[Candida] ipomoeae UWOPS 01-141c3
GCA_002370175.1	1572	1571	1	10	124	Metschnikowia colocasiae UWOPS 03-202.1
GCA_002370185.1	1577	1576	1	9	120	Metschnikowia sp. 01-655c1 UWOPS 01-655c1
GCA_002370245.1	1570	1569	1	8	128	Metschnikowia sp. 04-226.1 UWOPS 04-226.1
GCA_002370275.1	1560	1559	1	8	138	Metschnikowia shivogae UWOPS 07-203.2
GCA_002370295.1	1559	1557	2	8	139	Metschnikowia bowlesiae UWOPS 12-619.1
GCA_002370315.1	1573	1572	1	12	121	Metschnikowia kamakouana UWOPS 04-206.1
GCA_002370325.1	1564	1562	2	13	129	Metschnikowia hawaiiensis UWOPS 87-2203.2
GCA_002370455.1	1556	1555	1	13	137	Metschnikowia hibisci UWOPS 95-805.1
GCA_002370475.1	1564	1564	0	9	133	Metschnikowia drakensbergensis EBD-CdVSA10-2A
GCA_002370495.1	1555	1555	0	9	142	Metschnikowia proteae EBD-A10Y1
GCA_002370515.1	1564	1564	0	6	136	Metschnikowia proteae EBD-T1Y1T
GCA_002370575.1	1556	1555	1	9	141	Metschnikowia sp. M2Y3 EBD-CdV M2Y3
GCA_002370595.1	1560	1560	0	10	136	Metschnikowia drakensbergensis EBD-CdVSA09-2T
GCA_002370615.1	1565	1564	1	10	131	Metschnikowia aberdeeniae SUB 05-213.1
GCA_002370635.1	1582	1581	1	8	116	Metschnikowia cerradonensis UFMG 03-T67.1
GCA_002370645.1	1583	1583	0	9	114	Metschnikowia sp. 00-154.1 UWOPS 00-154.1
GCA_002370655.1	1583	1582	1	10	113	Metschnikowia matae var. matae UFMG-CM-Y391A
GCA_002370695.1	1584	1583	1	8	114	Metschnikowia matae var. maris UFMG-CM-Y397T
GCA_002370705.1	1581	1580	1	10	115	Metschnikowia santaceciliae UWOPS 01-142b1
GCA_002370735.1	1563	1560	3	12	131	Metschnikowia dekortorum UWOPS 03-172.2
GCA_002370755.1	1564	1562	2	9	133	Metschnikowia mauinuiana UWOPS 04-110.4
GCA_002370765.1	1560	1559	1	15	131	Metschnikowia similis UWOPS 03-133.4
GCA_002370795.1	1565	1564	1	10	131	Metschnikowia sp. 03-147.1 UWOPS 03-147.1
GCA_002370815.1	1568	1567	1	10	128	Metschnikowia hamakuensis UWOPS 04-199.1
GCA_002370825.1	1561	1559	2	6	139	Metschnikowia bowlesiae UWOPS 12-611.1
GCA_002370835.1	1585	1584	1	10	111	Metschnikowia continentalis UWOPS 95-402.1
GCA_002370855.1	1561	1560	1	19	126	Metschnikowia borealis UWOPS 96-101.1
GCA_002370875.1	1569	1568	1	10	127	Metschnikowia arizonensis UWOPS 99-103.4
GCA_002370905.1	1587	1586	1	6	113	[Candida] ipomoeae UWOPS 99-324.1
GCA_002370915.1	1582	1581	1	9	115	Metschnikowia lochheadii UWOPS 99-661.1
GCA_002374375.1	1581	1580	1	11	114	Metschnikowia matae var. matae UFMG-CM-Y395T
GCA_002374385.1	1552	1551	1	27	127	Metschnikowia borealis SUB 99-207.1
GCA_002374395.1	1579	1578	1	8	119	Metschnikowia cerradonensis UFMG 03-T68.1
GCA_002374405.1	1567	1566	1	13	126	Metschnikowia cubensis MUCL 45753
GCA_002374455.1	1555	1553	2	14	137	Metschnikowia dekortorum UWOPS 01-142b3
GCA_002374465.1	1570	1569	1	13	123	Metschnikowia colocasiae UWOPS 03-134.2
GCA_002374475.1	1561	1560	1	15	130	Metschnikowia similis UWOPS 03-158.2
GCA_002374485.1	1583	1582	1	11	112	Metschnikowia santaceciliae UWOPS 01-517a1
GCA_002374535.1	1578	1577	1	8	120	Metschnikowia kamakouana UWOPS 04-112.5
GCA_002374545.1	1580	1578	2	13	113	Metschnikowia lochheadii UWOPS 03-167a3
GCA_002374555.1	1570	1568	2	11	125	Metschnikowia mauinuiana UWOPS 04-190.1
GCA_002374595.1	1558	1557	1	17	131	Metschnikowia hamakuensis UWOPS 04-207.1
GCA_002374615.1	1561	1558	3	16	129	Metschnikowia bowlesiae UWOPS 04-243x5
GCA_002374635.1	1567	1565	2	14	125	Metschnikowia sp. 04-218.3 UWOPS 04-218.3
GCA_002374645.1	1564	1563	1	9	133	Metschnikowia shivogae UWOPS 04-310.1
GCA_002374675.1	1561	1560	1	11	134	Metschnikowia aberdeeniae UWOPS 07-202.1
GCA_002374695.1	1568	1545	23	12	126	Metschnikowia hawaiiensis UWOPS 91-745.2
GCA_002374715.1	1588	1587	1	6	112	[Candida] ipomoeae UWOPS 10-104.1
GCA_002374725.1	1563	1563	0	12	131	Metschnikowia hibisci UWOPS 95-797.2
GCA_002374735.1	1576	1574	2	18	112	Metschnikowia sp. 13-106.1 UWOPS 13-106.1
GCA_002374775.1	1584	1583	1	8	114	Metschnikowia continentalis UWOPS 96-173
GCA_002374795.1	1564	1563	1	9	133	Metschnikowia arizonensis UWOPS 99-103.3.1
GCA_002375215.1	1636	211	1425	3	67	Saccharomyces sp. M14 M14
GCA_002557695.1	1613	928	685	12	81	Saccharomyces pastorianus CBS 1503 CBS 1503
GCA_002564235.1	1463	1456	7	20	223	Saccharomycopsis fodiens CBS 8332
GCA_002564245.1	1394	1381	13	18	294	Saccharomycopsis fermentans CBS 7830
GCA_002571405.2	1625	1544	81	6	75	Saccharomyces cerevisiae CEN.PK113-7D; CBS 8340
GCA_002759435.2	1589	1587	2	7	110	[Candida] auris B8441
GCA_002775015.1	1591	1586	5	7	108	[Candida] auris B11221
GCA_002798095.1	1440	1439	1	15	251	Pichia kudriavzevii NG7
GCA_002804325.1	1624	1543	81	7	75	Saccharomyces cerevisiae I-328
GCA_002807125.1	1620	1546	74	6	80	Saccharomyces cerevisiae SPSC01
GCA_002835845.1	1604	147	1457	6	96	Candida albicans SC5314-GTH12
GCA_002837675.1	1611	61	1550	4	91	Candida albicans SC5314-P0
GCA_002864065.1	1551	1549	2	16	139	[Candida] boidinii
GCA_002864075.1	1480	1473	7	26	200	Candida tropicalis
GCA_002893645.1	1584	1583	1	10	112	[Candida] hawaiiana UWOPS91-698.3
GCA_002893665.1	1562	1562	0	17	127	Metschnikowia orientalis UWOPS99-745.6
GCA_002893685.1	1563	1562	1	14	129	Metschnikowia orientalis UWOPS05-269.1
GCA_002893705.1	1566	1566	0	10	130	Metschnikowia drosophilae UWOPS83-1143.1
GCA_002893725.1	1562	1562	0	11	133	[Candida] torresii CBS 5152
GCA_002893735.1	1566	1566	0	10	130	Metschnikowia drosophilae UWOPS83-1135.3
GCA_002894425.1	971	966	5	23	712	Hanseniaspora uvarum AWRI3581
GCA_002894445.1	1413	1409	4	18	275	Metschnikowia sp. AWRI3582 AWRI3582
GCA_002895615.1	1445	1436	9	12	249	Saccharomycopsis sp. UWO(PS) 91-127.1 UWO(PS) 91-127.1
GCA_002900925.1	1647	1646	1	4	55	Lachancea quebecensis
GCA_002911495.1	1621	1618	3	1	84	Spathaspora sp. UFMG-CM-Y6060 UFMG-CM-Y6060
GCA_002926055.1	1575	1574	1	9	122	[Candida] haemuloni B11899
GCA_002926085.1	1534	1531	3	9	163	[Candida] duobushaemulonis B09383
GCA_002933435.1	1582	1579	3	10	114	[Candida] pseudohaemulonis UZ153_17
GCA_002933895.1	1622	1537	85	7	77	Saccharomyces cerevisiae BAW-6
GCA_003004515.1	1637	266	1371	3	66	Saccharomyces pastorianus HA2560
GCA_003004545.1	1637	293	1344	6	63	Saccharomyces cerevisiae x Saccharomyces kudriavzevii HA1836
GCA_003013175.1	1629	1628	1	6	71	Torulaspora delbrueckii COFT1
GCA_003013715.2	1591	1590	1	7	108	[Candida] auris B11220
GCA_003013735.1	1585	1583	2	12	109	[Candida] pseudohaemulonis B12108
GCA_003014415.1	1599	1597	2	8	99	[Candida] auris B11243
GCA_003017285.1	1540	728	812	12	154	Metschnikowia fructicola AP47
GCA_003020065.1	1613	1526	87	9	84	Saccharomyces cerevisiae 98-5
GCA_003020785.1	1267	1267	0	32	407	Hanseniaspora gamundiae CRUB 1928
GCA_003033435.1	1104	1104	0	74	528	Starmerella magnoliae PYCC 2903
GCA_003033605.1	1603	1602	1	9	94	Zygosaccharomyces kombuchaensis CBS 8849
GCA_003033705.1	1217	1215	2	45	444	Wickerhamiella domercqiae PYCC 3067
GCA_003033765.1	1106	1102	4	25	575	Starmerella bacillaris PYCC 3044
GCA_003033785.1	1183	1181	2	34	489	Starmerella bombicola PYCC 5882
GCA_003033855.1	942	941	1	114	650	Pichia kudriavzevii SJP
GCA_003045245.1	1374	1370	4	29	303	Wickerhamiella galacta NRRL Y-17645
GCA_003046155.1	1617	1616	1	7	82	Kluyveromyces marxianus LHW-O
GCA_003046695.1	1629	1545	84	6	71	Saccharomyces cerevisiae I-30
GCA_003046715.1	1621	1541	80	6	79	Saccharomyces cerevisiae I-566
GCA_003046745.1	1627	1547	80	7	72	Saccharomyces cerevisiae I-329
GCA_003054305.1	1503	1496	7	7	196	Yarrowia lipolytica H222 (CLIB 80)
GCA_003054345.1	1540	1534	6	8	158	Yarrowia lipolytica W29 (CLIB89)
GCA_003054365.1	1515	1505	10	10	181	Yarrowia lipolytica IBT 446
GCA_003054405.1	1420	1416	4	19	267	Pichia kudriavzevii CBS5147
GCA_003054445.1	1436	1432	4	14	256	Pichia kudriavzevii CBS573
GCA_003086655.1	1625	1542	83	5	76	Saccharomyces cerevisiae BY4742
GCA_003123035.1	1599	1521	78	7	100	Nadsonia starkeyi-henricii UCD142
GCA_003123585.1	1608	1601	7	3	95	Barnettozyma californica UCD09
GCA_003123635.1	598	478	120	259	849	Metschnikowia aff. pulcherrima UCD127
GCA_003123885.1	1608	1601	7	3	95	Barnettozyma californica UCD89
GCA_003205855.1	1634	1631	3	8	64	Cyberlindnera fabianii YJS4271
GCA_003243015.1	1514	1484	30	13	179	Saccharomycopsis capsularis NRRL Y-17639
GCA_003243035.1	1591	1587	4	6	109	Nakazawaea wickerhamii NRRL Y-2563
GCA_003243065.1	1389	1388	1	12	305	Saturnispora dispora NRRL Y-1447
GCA_003243075.1	1598	1591	7	3	105	Peterozyma xylosa NRRL Y-12939
GCA_003243085.1	1560	1470	90	17	129	Citeromyces matritensis NRRL Y-2407
GCA_003243125.1	1560	1556	4	10	136	[Candida] boidinii NRRL Y-2332
GCA_003243135.1	1566	1553	13	8	132	Ambrosiozyma philentoma NRRL Y-7523
GCA_003243715.1	839	838	1	50	817	Hanseniaspora uvarum CBA6001
GCA_003243735.1	1512	1469	43	16	178	Kazachstania servazzii CBA6004
GCA_003243785.1	1582	1575	7	6	118	Yarrowia lipolytica CBA6003
GCA_003243815.1	1635	1631	4	7	64	[Candida] sake CBA6005
GCA_003260575.1	1082	1077	5	25	599	Starmerella bacillaris CBS 9494
GCA_003270095.1	1628	1547	81	3	75	Saccharomyces cerevisiae YN2
GCA_003270135.1	1603	1525	78	13	90	Saccharomyces cerevisiae LJQ13C.1
GCA_003270145.1	1599	1533	66	10	97	Saccharomyces cerevisiae LJQ13A.5
GCA_003270175.1	1630	1552	78	3	73	Saccharomyces cerevisiae MTJZ4
GCA_003270185.1	1633	1555	78	3	70	Saccharomyces cerevisiae LJZ22.1
GCA_003270205.1	1612	1538	74	4	90	Saccharomyces cerevisiae LJQ13.C7
GCA_003270245.1	1630	1549	81	3	73	Saccharomyces cerevisiae JZ10.1
GCA_003270305.1	1624	1548	76	6	76	Saccharomyces cerevisiae JT94.11
GCA_003270315.1	1630	1550	80	2	74	Saccharomyces cerevisiae JT49.3
GCA_003270325.1	1630	1550	80	3	73	Saccharomyces cerevisiae JT49.1
GCA_003270335.1	1630	1552	78	2	74	Saccharomyces cerevisiae JT43.1
GCA_003270425.1	1603	1525	78	12	91	Saccharomyces cerevisiae JT21.3
GCA_003270435.1	1630	1553	77	4	72	Saccharomyces cerevisiae JT21.1
GCA_003270455.1	1627	1545	82	3	76	Saccharomyces cerevisiae HN6.1
GCA_003270465.1	1627	1547	80	4	75	Saccharomyces cerevisiae BJ1
GCA_003270535.1	1628	1550	78	2	76	Saccharomyces cerevisiae 502
GCA_003270565.1	1630	1552	78	3	73	Saccharomyces cerevisiae 155
GCA_003270575.1	1631	1552	79	1	74	Saccharomyces cerevisiae 2.591
GCA_003270595.1	1630	1549	81	3	73	Saccharomyces cerevisiae MTJZ2
GCA_003270665.1	1628	1548	80	3	75	Saccharomyces cerevisiae JQ10.6
GCA_003270695.1	1628	1551	77	2	76	Saccharomyces cerevisiae JM32.8
GCA_003270705.1	1632	1553	79	2	72	Saccharomyces cerevisiae JM32.3
GCA_003270715.1	1631	1555	76	3	72	Saccharomyces cerevisiae LJQ131.6
GCA_003270765.1	1629	1554	75	4	73	Saccharomyces cerevisiae JTHB1
GCA_003270815.1	1628	1548	80	2	76	Saccharomyces cerevisiae JT10.10
GCA_003270825.1	1632	1552	80	3	71	Saccharomyces cerevisiae JQHG.1
GCA_003270835.1	1625	1547	78	5	76	Saccharomyces cerevisiae JQ8.4
GCA_003270855.1	1629	1551	78	3	74	Saccharomyces cerevisiae JQ8.3
GCA_003270935.1	1630	1550	80	3	73	Saccharomyces cerevisiae CJM24.1
GCA_003270945.1	1631	1552	79	3	72	Saccharomyces cerevisiae 427
GCA_003270955.1	1631	1555	76	2	73	Saccharomyces cerevisiae 229
GCA_003270985.1	1629	1549	80	5	72	Saccharomyces cerevisiae 168
GCA_003271045.1	1633	1552	81	2	71	Saccharomyces cerevisiae MTJZ1
GCA_003271085.1	1628	1549	79	4	74	Saccharomyces cerevisiae MJQ3.1
GCA_003271115.1	1631	1552	79	2	73	Saccharomyces cerevisiae HN3.8
GCA_003271125.1	1629	1548	81	2	75	Saccharomyces cerevisiae BQ1.1
GCA_003271135.1	1629	1550	79	3	74	Saccharomyces cerevisiae 2.1392
GCA_003271185.1	1577	1502	75	22	107	Saccharomyces cerevisiae MTZ13.12
GCA_003271225.1	1625	1545	80	4	77	Saccharomyces cerevisiae MTJZ3
GCA_003271245.1	1632	1553	79	2	72	Saccharomyces cerevisiae HZJZ5.5
GCA_003271255.1	1631	1553	78	3	72	Saccharomyces cerevisiae HZJZ5.4
GCA_003271315.1	1630	1551	79	3	73	Saccharomyces cerevisiae HZJZ4.5
GCA_003271355.1	1631	1550	81	2	73	Saccharomyces cerevisiae HLJ225
GCA_003271365.1	1629	1548	81	2	75	Saccharomyces cerevisiae HLJ201
GCA_003271395.1	1630	1547	83	3	73	Saccharomyces cerevisiae HLJ167
GCA_003271425.1	1630	1550	80	2	74	Saccharomyces cerevisiae TY3.9
GCA_003271475.1	1629	1548	81	2	75	Saccharomyces cerevisiae TY2.1
GCA_003271505.1	1618	1540	78	7	81	Saccharomyces cerevisiae JQ9.3
GCA_003271535.1	1626	1546	80	2	78	Saccharomyces cerevisiae TY1.5
GCA_003271545.1	1629	1546	83	3	74	Saccharomyces cerevisiae JQ9.4
GCA_003271555.1	1630	1550	80	3	73	Saccharomyces cerevisiae JL2
GCA_003271565.1	1630	1549	81	2	74	Saccharomyces cerevisiae HN5.1
GCA_003271645.1	1628	1550	78	5	73	Saccharomyces cerevisiae XZ10.1
GCA_003271675.1	1629	1550	79	4	73	Saccharomyces cerevisiae XZ2.1
GCA_003271695.1	1631	1551	80	3	72	Saccharomyces cerevisiae JT49.4
GCA_003271705.1	1631	1552	79	3	72	Saccharomyces cerevisiae XZ7
GCA_003271775.1	1628	1547	81	4	74	Saccharomyces cerevisiae SXJM6.6
GCA_003271805.1	1628	1548	80	3	75	Saccharomyces cerevisiae HN2.2
GCA_003271815.1	1632	1553	79	4	70	Saccharomyces cerevisiae YM3.1
GCA_003271825.1	1605	1523	82	11	90	Saccharomyces cerevisiae JM28.13
GCA_003271835.1	1631	1552	79	2	73	Saccharomyces cerevisiae BM5.1
GCA_003271925.1	1630	1550	80	3	73	Saccharomyces cerevisiae QH6.5
GCA_003271935.1	1629	1550	79	3	74	Saccharomyces cerevisiae QH7.4
GCA_003271945.1	1607	1545	62	7	92	Saccharomyces cerevisiae NX4.1
GCA_003271955.1	1627	1548	79	4	75	Saccharomyces cerevisiae QH3.1
GCA_003272045.1	1626	1549	77	7	73	Saccharomyces cerevisiae NX8.1
GCA_003272055.1	1628	1545	83	2	76	Saccharomyces cerevisiae WL4
GCA_003272065.1	1627	1545	82	6	73	Saccharomyces cerevisiae QH2.1
GCA_003272075.1	1630	1551	79	3	73	Saccharomyces cerevisiae SXJM1.1
GCA_003272165.1	1627	1548	79	5	74	Saccharomyces cerevisiae QH7.3
GCA_003272175.1	1629	1548	81	3	74	Saccharomyces cerevisiae JM8.3
GCA_003272185.1	1628	1550	78	2	76	Saccharomyces cerevisiae NX7.1
GCA_003272195.1	1629	1550	79	3	74	Saccharomyces cerevisiae JM4.8
GCA_003272285.1	1631	1555	76	4	71	Saccharomyces cerevisiae JM14.3
GCA_003272295.1	1628	1549	79	5	73	Saccharomyces cerevisiae JM13.2
GCA_003272305.1	1627	1545	82	6	73	Saccharomyces cerevisiae GS5.7
GCA_003272315.1	1630	1554	76	6	70	Saccharomyces cerevisiae GS5.6
GCA_003272405.1	1623	1544	79	8	75	Saccharomyces cerevisiae GS1
GCA_003272415.1	1628	1546	82	4	74	Saccharomyces cerevisiae DJM4.1
GCA_003272425.1	1626	1544	82	5	75	Saccharomyces cerevisiae CJM20.1
GCA_003272445.1	1630	1551	79	3	73	Saccharomyces cerevisiae CJM11.1
GCA_003272525.1	1630	1550	80	4	72	Saccharomyces cerevisiae ANGGW.1
GCA_003272535.1	1627	1545	82	4	75	Saccharomyces cerevisiae NX8.3
GCA_003272575.1	1632	1555	77	2	72	Saccharomyces cerevisiae WJZ1.2
GCA_003272595.1	1631	1555	76	5	70	Saccharomyces cerevisiae WJM5.2
GCA_003272625.1	1629	1550	79	4	73	Saccharomyces cerevisiae LJM6A.4
GCA_003272665.1	1630	1551	79	3	73	Saccharomyces cerevisiae LJM6A.1
GCA_003272705.1	1628	1552	76	3	75	Saccharomyces cerevisiae LJM21.10
GCA_003272715.1	1628	1553	75	4	74	Saccharomyces cerevisiae LJM21.1
GCA_003272725.1	1628	1551	77	4	74	Saccharomyces cerevisiae CJM25.5
GCA_003272755.1	1629	1554	75	5	72	Saccharomyces cerevisiae CJM25.4
GCA_003272815.1	1631	1556	75	3	72	Saccharomyces cerevisiae CJM25.1
GCA_003272835.1	1629	1552	77	4	73	Saccharomyces cerevisiae CJM21.4
GCA_003272855.1	1628	1550	78	3	75	Saccharomyces cerevisiae CJM19.6
GCA_003272905.1	1627	1551	76	4	75	Saccharomyces cerevisiae BT3
GCA_003272925.1	1629	1550	79	5	72	Saccharomyces cerevisiae BT2.6
GCA_003272945.1	1554	1505	49	15	137	Saccharomyces cerevisiae XJ7.3
GCA_003272975.1	1626	1546	80	6	74	Saccharomyces cerevisiae XJ2
GCA_003273025.1	1630	1557	73	2	74	Saccharomyces cerevisiae WM11-3
GCA_003273035.1	1633	1552	81	3	70	Saccharomyces cerevisiae WM7-1
GCA_003273045.1	1631	1554	77	4	71	Saccharomyces cerevisiae QH21-3
GCA_003273075.1	1632	1554	78	1	73	Saccharomyces cerevisiae QH1-3
GCA_003273145.1	1631	1546	85	3	72	Saccharomyces cerevisiae HQ3.1
GCA_003273155.1	1630	1552	78	4	72	Saccharomyces cerevisiae NQ13-1
GCA_003273165.1	1630	1551	79	4	72	Saccharomyces cerevisiae HQ1.1
GCA_003273175.1	1560	1490	70	27	119	Saccharomyces cerevisiae CQJZ1.4
GCA_003273265.1	1628	1550	78	4	74	Saccharomyces cerevisiae BTP1
GCA_003273275.1	1629	1549	80	2	75	Saccharomyces cerevisiae BQ8.2
GCA_003273285.1	1629	1549	80	2	75	Saccharomyces cerevisiae BQ8.1
GCA_003273295.1	1630	1549	81	3	73	Saccharomyces cerevisiae ANG.CJ.1
GCA_003273385.1	1629	1549	80	2	75	Saccharomyces cerevisiae HLJ59
GCA_003273395.1	1628	1547	81	3	75	Saccharomyces cerevisiae HLJ10
GCA_003273405.1	1628	1547	81	3	75	Saccharomyces cerevisiae HLJ4
GCA_003273415.1	1626	1539	87	4	76	Saccharomyces cerevisiae GZLJ3.30
GCA_003273495.1	1625	1545	80	4	77	Saccharomyces cerevisiae GZLJ3.22
GCA_003273535.1	1629	1549	80	1	76	Saccharomyces cerevisiae GZLJ3.19
GCA_003273555.1	1627	1547	80	4	75	Saccharomyces cerevisiae GZLJ3.1
GCA_003273575.1	1628	1549	79	3	75	Saccharomyces cerevisiae TY1.4
GCA_003273585.1	1628	1550	78	4	74	Saccharomyces cerevisiae XZ4.2
GCA_003273625.1	1628	1547	81	4	74	Saccharomyces cerevisiae XZ4.1
GCA_003273685.1	1629	1548	81	5	72	Saccharomyces cerevisiae XZ3.1
GCA_003273695.1	1630	1550	80	4	72	Saccharomyces cerevisiae JM28.2
GCA_003273705.1	1633	1556	77	3	70	Saccharomyces cerevisiae QH7.2
GCA_003273725.1	1628	1545	83	5	73	Saccharomyces cerevisiae QH1.1
GCA_003273805.1	1629	1553	76	5	72	Saccharomyces cerevisiae GS3.1
GCA_003273815.1	1625	1547	78	6	75	Saccharomyces cerevisiae WL2
GCA_003273825.1	1629	1547	82	5	72	Saccharomyces cerevisiae WL1
GCA_003273835.1	1627	1546	81	4	75	Saccharomyces cerevisiae SXJM9.5
GCA_003273925.1	1632	1550	82	4	70	Saccharomyces cerevisiae JM37.2
GCA_003273935.1	1631	1552	79	2	73	Saccharomyces cerevisiae JM22.1
GCA_003273955.1	1623	1538	85	8	75	Saccharomyces cerevisiae GS6
GCA_003273985.1	1626	1545	81	5	75	Saccharomyces cerevisiae CJM6.2
GCA_003274025.1	1631	1555	76	3	72	Saccharomyces cerevisiae LJM21.9
GCA_003274055.1	1629	1549	80	3	74	Saccharomyces cerevisiae LJM21.3
GCA_003274085.1	1629	1548	81	3	74	Saccharomyces cerevisiae HN1.9
GCA_003274095.1	1629	1551	78	3	74	Saccharomyces cerevisiae CJM19.5
GCA_003274125.1	1627	1548	79	5	74	Saccharomyces cerevisiae WL3
GCA_003274195.1	1630	1555	75	3	73	Saccharomyces cerevisiae QH45-2
GCA_003274205.1	1633	1553	80	3	70	Saccharomyces cerevisiae QH25-4
GCA_003274215.1	1629	1549	80	4	73	Saccharomyces cerevisiae BT2.8
GCA_003274225.1	1630	1550	80	4	72	Saccharomyces cerevisiae BT1.1
GCA_003274315.1	1630	1554	76	6	70	Saccharomyces cerevisiae LM1-2
GCA_003274325.1	1624	1546	78	5	77	Saccharomyces cerevisiae JZ1-4
GCA_003274345.1	1626	1552	74	5	75	Saccharomyces cerevisiae F3-4
GCA_003274365.1	1630	1554	76	3	73	Saccharomyces cerevisiae DX10-3
GCA_003274425.1	1630	1554	76	4	72	Saccharomyces cerevisiae 11-3002
GCA_003274465.1	1633	1558	75	3	70	Saccharomyces cerevisiae 5-3004
GCA_003274475.1	1630	1551	79	5	71	Saccharomyces cerevisiae XJ5
GCA_003274485.1	1628	1548	80	5	73	Saccharomyces cerevisiae NX3
GCA_003274495.1	1630	1552	78	4	72	Saccharomyces cerevisiae NX2
GCA_003274585.1	1631	1551	80	3	72	Saccharomyces cerevisiae NX1
GCA_003274595.1	1622	1535	87	7	77	Saccharomyces cerevisiae SXJM4.1
GCA_003274605.1	1629	1548	81	5	72	Saccharomyces cerevisiae LSF.1
GCA_003274615.1	1625	1546	79	7	74	Saccharomyces cerevisiae DBL.1
GCA_003274705.1	1595	1529	66	12	99	Saccharomyces cerevisiae AF
GCA_003274715.1	1630	1549	81	6	70	Saccharomyces cerevisiae BJ13
GCA_003274725.1	1630	1549	81	6	70	Saccharomyces cerevisiae BJ11
GCA_003274735.1	1629	1548	81	7	70	Saccharomyces cerevisiae BJ10
GCA_003274825.1	1627	1546	81	7	72	Saccharomyces cerevisiae BJ9
GCA_003274845.1	1630	1548	82	4	72	Saccharomyces cerevisiae JL1
GCA_003274855.1	1628	1547	81	5	73	Saccharomyces cerevisiae JL3
GCA_003274865.1	1631	1550	81	4	71	Saccharomyces cerevisiae YN6
GCA_003274905.1	1632	1554	78	4	70	Saccharomyces cerevisiae YN4
GCA_003274975.1	1630	1549	81	4	72	Saccharomyces cerevisiae YN1
GCA_003274985.1	1627	1545	82	5	74	Saccharomyces cerevisiae XJ6
GCA_003274995.1	1630	1552	78	3	73	Saccharomyces cerevisiae YN3
GCA_003275005.1	1626	1547	79	6	74	Saccharomyces cerevisiae XJ7
GCA_003275095.1	1631	1551	80	3	72	Saccharomyces cerevisiae XJ1
GCA_003275105.1	1628	1549	79	6	72	Saccharomyces cerevisiae SX11
GCA_003275115.1	1629	1548	81	3	74	Saccharomyces cerevisiae SX10
GCA_003275125.1	1628	1548	80	6	72	Saccharomyces cerevisiae SD2
GCA_003275215.1	1626	1544	82	4	76	Saccharomyces cerevisiae SD1
GCA_003275225.1	1628	1549	79	6	72	Saccharomyces cerevisiae HLJ3
GCA_003275235.1	1628	1549	79	5	73	Saccharomyces cerevisiae JL4
GCA_003275245.1	1626	1547	79	6	74	Saccharomyces cerevisiae FJ12
GCA_003275335.1	1630	1550	80	3	73	Saccharomyces cerevisiae BJ7
GCA_003275345.1	1626	1544	82	5	75	Saccharomyces cerevisiae BJ4
GCA_003275365.1	1628	1552	76	4	74	Saccharomyces cerevisiae ZJ2
GCA_003275385.1	1631	1555	76	4	71	Saccharomyces cerevisiae ZJ1
GCA_003275455.1	1628	1548	80	5	73	Saccharomyces cerevisiae SX9
GCA_003275465.1	1627	1548	79	6	73	Saccharomyces cerevisiae HN18
GCA_003275475.1	1627	1547	80	4	75	Saccharomyces cerevisiae HN17
GCA_003275505.1	1627	1548	79	6	73	Saccharomyces cerevisiae HN16
GCA_003275575.1	1625	1546	79	6	75	Saccharomyces cerevisiae HN15
GCA_003275585.1	1628	1549	79	5	73	Saccharomyces cerevisiae HN13
GCA_003275605.1	1629	1550	79	5	72	Saccharomyces cerevisiae FJ6
GCA_003275615.1	1625	1544	81	6	75	Saccharomyces cerevisiae FJ4
GCA_003275685.1	1627	1548	79	4	75	Saccharomyces cerevisiae FJ3
GCA_003275715.1	1629	1548	81	5	72	Saccharomyces cerevisiae NGS21L.1
GCA_003275745.1	1599	1520	79	17	90	Saccharomyces cerevisiae JHBMY20.1
GCA_003275755.1	1630	1550	80	5	71	Saccharomyces cerevisiae JXXY1.1
GCA_003275785.1	1632	1551	81	5	69	Saccharomyces cerevisiae GT99.1
GCA_003275825.1	1631	1549	82	3	72	Saccharomyces cerevisiae GT39.1
GCA_003275835.1	1628	1546	82	6	72	Saccharomyces cerevisiae FJSA40.2
GCA_003275875.1	1629	1547	82	5	72	Saccharomyces cerevisiae FJ11
GCA_003275885.1	1630	1549	81	6	70	Saccharomyces cerevisiae HN19
GCA_003275955.1	1631	1546	85	5	70	Saccharomyces cerevisiae HN10
GCA_003275965.1	1629	1549	80	7	70	Saccharomyces cerevisiae HN9
GCA_003276005.1	1630	1550	80	3	73	Saccharomyces cerevisiae BJ27
GCA_003276015.1	1628	1547	81	4	74	Saccharomyces cerevisiae BJ25
GCA_003276075.1	1631	1552	79	4	71	Saccharomyces cerevisiae BJ19
GCA_003276085.1	1629	1553	76	4	73	Saccharomyces cerevisiae BJ20
GCA_003276135.1	1631	1553	78	4	71	Saccharomyces cerevisiae C5-1
GCA_003276145.1	1629	1553	76	4	73	Saccharomyces cerevisiae B1-1
GCA_003276185.1	1589	1513	76	13	104	Saccharomyces cerevisiae XST
GCA_003276205.1	1628	1550	78	6	72	Saccharomyces cerevisiae MLAF.1
GCA_003276235.1	1629	1549	80	5	72	Saccharomyces cerevisiae ANG1
GCA_003276245.1	1626	1546	80	6	74	Saccharomyces cerevisiae AFB.1
GCA_003276295.1	1629	1548	81	5	72	Saccharomyces cerevisiae XJ4
GCA_003276325.1	1626	1546	80	6	74	Saccharomyces cerevisiae BJ5
GCA_003276365.1	1630	1547	83	5	71	Saccharomyces cerevisiae BJ2
GCA_003276375.1	1629	1549	80	4	73	Saccharomyces cerevisiae SD4
GCA_003276395.1	1629	1549	80	4	73	Saccharomyces cerevisiae YN5
GCA_003276405.1	1629	1550	79	6	71	Saccharomyces cerevisiae XJ3
GCA_003276485.1	1629	1549	80	5	72	Saccharomyces cerevisiae SD3
GCA_003276495.1	1629	1549	80	5	72	Saccharomyces cerevisiae HLJ2
GCA_003276505.1	1627	1546	81	7	72	Saccharomyces cerevisiae FJ1
GCA_003276515.1	1629	1545	84	4	73	Saccharomyces cerevisiae HN14
GCA_003276605.1	1628	1552	76	4	74	Saccharomyces cerevisiae FJ2
GCA_003276615.1	1629	1550	79	6	71	Saccharomyces cerevisiae HN11
GCA_003276625.1	1630	1551	79	6	70	Saccharomyces cerevisiae HN8
GCA_003276635.1	1630	1550	80	3	73	Saccharomyces cerevisiae JL5
GCA_003276725.1	1633	1549	84	2	71	Saccharomyces cerevisiae HLJ1
GCA_003276735.1	1632	1549	83	4	70	Saccharomyces cerevisiae BJ26
GCA_003276745.1	1630	1550	80	6	70	Saccharomyces cerevisiae BJ24
GCA_003276755.1	1629	1549	80	5	72	Saccharomyces cerevisiae BJ23
GCA_003276845.1	1631	1550	81	3	72	Saccharomyces cerevisiae BJ18
GCA_003276855.1	1633	1553	80	2	71	Saccharomyces cerevisiae BJ22
GCA_003276865.1	1630	1548	82	4	72	Saccharomyces cerevisiae BJ17
GCA_003276875.1	1628	1551	77	6	72	Saccharomyces cerevisiae BJ14
GCA_003276965.1	1630	1549	81	2	74	Saccharomyces cerevisiae BJ6
GCA_003276975.1	1629	1549	80	5	72	Saccharomyces cerevisiae SX8
GCA_003276985.1	1625	1542	83	6	75	Saccharomyces cerevisiae SX7
GCA_003276995.1	1627	1547	80	7	72	Saccharomyces cerevisiae SX5
GCA_003277085.1	1632	1553	79	4	70	Saccharomyces cerevisiae SX3
GCA_003277095.1	1628	1547	81	6	72	Saccharomyces cerevisiae SX2
GCA_003277105.1	1628	1548	80	4	74	Saccharomyces cerevisiae HN7
GCA_003277115.1	1629	1547	82	4	73	Saccharomyces cerevisiae HN6
GCA_003277205.1	1627	1547	80	5	74	Saccharomyces cerevisiae HN5
GCA_003277235.1	1627	1547	80	4	75	Saccharomyces cerevisiae HN2
GCA_003277245.1	1627	1547	80	5	74	Saccharomyces cerevisiae HN4
GCA_003277255.1	1627	1551	76	4	75	Saccharomyces cerevisiae HN1
GCA_003277295.1	1628	1549	79	4	74	Saccharomyces cerevisiae FJ10
GCA_003277355.1	1630	1550	80	4	72	Saccharomyces cerevisiae FJ9
GCA_003277365.1	1627	1549	78	5	74	Saccharomyces cerevisiae FJ8
GCA_003277375.1	1627	1548	79	4	75	Saccharomyces cerevisiae FJ7
GCA_003277385.1	1630	1552	78	5	71	Saccharomyces cerevisiae FJ5
GCA_003277475.1	1629	1547	82	6	71	Saccharomyces cerevisiae XXYS14.1
GCA_003277485.1	1628	1547	81	6	72	Saccharomyces cerevisiae XXY30L.2
GCA_003277495.1	1627	1545	82	7	72	Saccharomyces cerevisiae XXY26L.1
GCA_003277505.1	1628	1548	80	7	71	Saccharomyces cerevisiae JXXY10.1
GCA_003277595.1	1624	1544	80	7	75	Saccharomyces cerevisiae BJ16
GCA_003277615.1	1631	1551	80	5	70	Saccharomyces cerevisiae BJ8
GCA_003277635.1	1630	1547	83	2	74	Saccharomyces cerevisiae BJ15
GCA_003277645.1	1631	1551	80	2	73	Saccharomyces cerevisiae BJ3
GCA_003277715.1	1623	1543	80	6	77	Saccharomyces cerevisiae SX6
GCA_003277725.1	1629	1550	79	6	71	Saccharomyces cerevisiae SX1
GCA_003277735.1	1630	1550	80	6	70	Saccharomyces cerevisiae SX4
GCA_003277755.1	1627	1546	81	4	75	Saccharomyces cerevisiae HN3
GCA_003277815.1	1629	1549	80	6	71	Saccharomyces cerevisiae XXYS1.4
GCA_003277865.1	1629	1548	81	6	71	Saccharomyces cerevisiae JXXY16.1
GCA_003277875.1	1620	1542	78	6	80	Saccharomyces cerevisiae BS
GCA_003285555.1	1375	1373	2	57	274	Diutina catenulata
GCA_003326515.1	1619	1551	68	6	81	Saccharomyces cerevisiae BT4
GCA_003326525.1	1630	1552	78	3	73	Saccharomyces cerevisiae BJ21
GCA_003326555.1	1628	1547	81	5	73	Saccharomyces cerevisiae BJ28
GCA_003326565.1	1581	1497	84	8	117	Saccharomyces cerevisiae JM28-16
GCA_003327605.1	1627	1544	83	5	74	Saccharomyces eubayanus CBS12357
GCA_003327635.1	1617	1533	84	5	84	Saccharomyces kudriavzevii CR85
GCA_003327685.1	1055	866	189	71	580	Pichia kluyveri CBA6002
GCA_003327735.1	1528	503	1025	23	155	Candida viswanathii ATCC 20962
GCA_003339355.1	1359	1358	1	27	320	Pichia fermentans fo/MP/02
GCA_003339405.1	1413	1412	1	18	275	Pichia norvegensis CBS 1922
GCA_003349505.1	1669	1664	5	1	36	Debaryomyces hansenii Y-3
GCA_003367845.1	1584	1573	11	6	116	Yarrowia lipolytica YB567
GCA_003367865.1	1583	1573	10	5	118	Yarrowia lipolytica YB392
GCA_003367925.1	1583	1573	10	6	117	Yarrowia lipolytica YB419
GCA_003367945.1	1585	1574	11	5	116	Yarrowia lipolytica YB566
GCA_003367965.1	1585	1575	10	4	117	Yarrowia lipolytica YB420
GCA_003401565.2	1544	1368	176	22	140	Metschnikowia reukaufii MR1
GCA_003401635.1	1499	1493	6	29	178	Metschnikowia reukaufii MR1
GCA_003454735.1	1571	1564	7	6	129	Candida albicans TIMM 1768
GCA_003569725.1	1625	1546	79	6	75	Saccharomyces cerevisiae Hm-1
GCA_003571375.1	1567	1557	10	13	126	Yarrowia lipolytica NCIM 3590
GCA_003571385.1	1582	1570	12	6	118	Yarrowia lipolytica NCIM 3589
GCA_003591695.1	1489	1415	74	27	190	Saccharomyces cerevisiae YAL1
GCA_003614695.1	1357	1326	31	55	294	Metschnikowia bicuspidata Baker2002
GCA_003670155.1	1603	1602	1	7	96	Kluyveromyces nonfermentans NRRL Y-27343
GCA_003671565.1	1624	1623	1	8	74	Zygotorulaspora mrakii NRRL Y-12654
GCA_003671575.2	1630	1629	1	9	67	Zygotorulaspora florentina NRRL Y-1560
GCA_003671595.2	1616	1610	6	3	87	Komagataella pseudopastoris NRRL Y-27603
GCA_003675435.1	1514	1512	2	23	169	Clavispora lusitaniae S19
GCA_003675455.1	1513	1454	59	25	168	Clavispora lusitaniae L15
GCA_003675475.1	1514	1512	2	22	170	Clavispora lusitaniae U04
GCA_003675495.1	1512	1510	2	22	172	Clavispora lusitaniae S20
GCA_003675505.1	1518	1516	2	18	170	Clavispora lusitaniae ATCC 42720
GCA_003675535.1	1517	1515	2	22	167	Clavispora lusitaniae S21
GCA_003675555.2	1506	1504	2	14	186	Clavispora lusitaniae L17
GCA_003675575.1	1514	1512	2	24	168	Clavispora lusitaniae L16
GCA_003675595.1	1516	1514	2	27	163	Clavispora lusitaniae S18
GCA_003675615.1	1513	1511	2	24	169	Clavispora lusitaniae L14
GCA_003675625.1	1518	1516	2	23	165	Clavispora lusitaniae L13
GCA_003675655.1	1515	1511	4	23	168	Clavispora lusitaniae L11
GCA_003675665.1	1516	1514	2	25	165	Clavispora lusitaniae L10
GCA_003675685.1	1519	1517	2	24	163	Clavispora lusitaniae L12
GCA_003675715.1	1512	1495	17	27	167	Clavispora lusitaniae L09
GCA_003675725.1	1513	1511	2	25	168	Clavispora lusitaniae U08
GCA_003675755.1	1508	1491	17	25	173	Clavispora lusitaniae U07
GCA_003675775.1	1516	1514	2	22	168	Clavispora lusitaniae U06
GCA_003675795.1	1511	1509	2	26	169	Clavispora lusitaniae U05
GCA_003675805.1	1514	1512	2	23	169	Clavispora lusitaniae U02
GCA_003675835.1	1512	1510	2	26	168	Clavispora lusitaniae U03
GCA_003676015.1	1629	1627	2	5	72	Meyerozyma sp. JA9 JA9
GCA_003676035.1	1620	1614	6	3	83	Spathaspora sp. JA1 JA1
GCA_003698155.1	1559	1552	7	7	140	Yarrowia lipolytica FKP355
GCA_003705115.1	1593	1587	6	10	103	Ogataea henricii NRRL YB-2194
GCA_003705165.1	1560	1470	90	17	129	Citeromyces matritensis NRRL Y-2407
GCA_003705175.2	1628	1620	8	6	72	Torulaspora franciscae NRRL Y-17532
GCA_003705185.1	1558	1550	8	5	143	Ambrosiozyma ambrosiae NRRL Y-7524
GCA_003705215.2	1472	1468	4	10	224	Brettanomyces custersianus NRRL Y-6653
GCA_003705225.1	1565	1560	5	5	136	Ambrosiozyma vanderkliftii NRRL Y-63633
GCA_003705255.2	1611	1605	6	3	92	Komagataella populi NRRL YB-455
GCA_003705275.1	1618	1615	3	7	81	Starmera quercuum NRRL YB-4281
GCA_003705295.1	1481	1466	15	26	199	Sporopachydermia lactativora NRRL Y-11591
GCA_003705305.2	1590	1578	12	11	105	Spencermartinsiella europaea NRRL Y-48265
GCA_003705335.1	1625	1624	1	5	76	Priceomyces medius NRRL Y-7122
GCA_003705365.1	1338	1337	1	22	346	Saturnispora mendoncae NRRL Y-11515
GCA_003705375.1	1514	1484	30	13	179	Saccharomycopsis capsularis NRRL Y-17639
GCA_003705415.1	1374	1372	2	11	321	Saturnispora serradocipensis NRRL Y-48717
GCA_003705435.1	1380	1378	2	14	312	Saturnispora zaruensis NRRL Y-7008
GCA_003705455.2	1460	1454	6	7	239	Pichia occidentalis NRRL Y-7552
GCA_003705465.1	1418	1387	31	14	274	Pichia norvegensis NRRL Y-7687
GCA_003705495.1	1391	1389	2	16	299	Pichia nakasei NRRL Y-7686
GCA_003705515.2	1438	1412	26	15	253	Pichia kudriavzevii NRRL Y-5396
GCA_003705525.2	1418	1415	3	12	276	Pichia heedii NRRL Y-10967
GCA_003705535.2	1098	1083	15	177	431	Martiniozyma abiesophila NRRL Y-11514
GCA_003705555.1	1615	1612	3	6	85	Meyerozyma athensensis NRRL Y-27644
GCA_003705595.1	1597	1521	76	6	103	Nadsonia fulvescens var. fulvescens NRRL Y-12810 NRRL Y-12810
GCA_003705615.1	1297	1286	11	31	378	Wickerhamiella cacticola NRRL Y-27362
GCA_003705625.1	1586	1583	3	3	117	Ogataea nitratoaversa NRRL Y-48449
GCA_003705635.1	1541	1528	13	7	158	Diddensiella caesifluorescens NRRL Y-48781
GCA_003705675.1	1609	1601	8	5	92	Kodamaea laetipori NRRL Y-27713
GCA_003705695.1	1607	1595	12	6	93	Blastobotrys serpentis NRRL Y-48249
GCA_003705705.1	1620	1606	14	4	82	Blastobotrys raffinosifermentans NRRL Y-27150
GCA_003705735.2	1595	1588	7	10	101	Blastobotrys peoriensis NRRL YB-2290
GCA_003705745.2	1582	1571	11	11	113	Blastobotrys muscicola NRRL Y-7993
GCA_003705765.2	1576	1565	11	10	120	Blastobotrys mokoenaii NRRL Y-27120
GCA_003705795.2	1600	1593	7	3	103	Blastobotrys americana NRRL Y-6844
GCA_003705805.2	1615	1607	8	8	83	Kluyveromyces dobzhanskii NRRL Y-1974
GCA_003705835.2	1315	1307	8	45	346	Lipomyces suomiensis NRRL Y-17356
GCA_003705845.2	1141	1133	8	90	475	Lipomyces mesembrius NRRL Y-27506
GCA_003705865.1	1050	1044	6	100	556	Lipomyces doorenjongii NRRL Y-27504
GCA_003705895.1	1350	1343	7	39	317	Lipomyces japonicus NRRL Y-17848
GCA_003705905.1	1191	1183	8	83	432	Lipomyces kononenkoae NRRL Y-11553
GCA_003705915.1	1186	1176	10	70	450	Lipomyces lipofer NRRL Y-11555
GCA_003705955.1	1631	1630	1	2	73	Zygosaccharomyces kombuchaensis NRRL YB-4811
GCA_003705975.1	1589	1523	66	4	113	Tetrapisispora iriomotensis NRRL Y-27309
GCA_003705985.1	1584	1528	56	8	114	Tetrapisispora namnaoensis NRRL Y-27982
GCA_003706005.1	1633	1605	28	4	69	Torulaspora pretoriensis NRRL Y-17251
GCA_003706035.1	1598	1591	7	3	105	Peterozyma xylosa NRRL Y-12939
GCA_003706045.1	1599	1587	12	5	102	Peterozyma toletana NRRL YB-4247
GCA_003706095.1	1567	1563	4	9	130	Ogataea trehaloabstinens NRRL Y-27595
GCA_003706105.2	1568	1566	2	8	130	Ogataea ramenticola NRRL YB-1985
GCA_003706115.2	1568	1562	6	6	132	Ogataea philodendri NRRL Y-7210
GCA_003706155.1	1603	1593	10	10	93	Ogataea glucozyma NRRL YB-2185
GCA_003706165.2	1540	1538	2	12	154	Ogataea kodamae NRRL Y-17234
GCA_003706195.1	1558	1554	4	9	139	Ogataea minuta NRRL Y-411
GCA_003706205.1	1610	1600	10	6	90	Ogataea methylovora NRRL Y-17250
GCA_003706235.1	1563	1561	2	10	133	Ogataea naganishii NRRL Y-7654
GCA_003706255.1	1565	1560	5	11	130	Ogataea nonfermentans NRRL YB-2203
GCA_003706265.1	1604	1595	9	5	97	Nakazawaea holstii NRRL Y-2155
GCA_003706285.2	1632	1630	2	5	69	Kuraishia ogatae NRRL Y-48474
GCA_003706305.2	1588	1586	2	10	108	Kuraishia molischiana NRRL Y-27899
GCA_003706315.2	1561	1553	8	3	142	Ambrosiozyma oregonensis NRRL Y-6106
GCA_003706345.1	1540	1498	42	17	149	Citeromyces hawaiiensis NRRL Y-11581
GCA_003706365.1	1504	1098	406	36	166	Citeromyces siamensis NRRL Y-27975
GCA_003706385.1	1007	1000	7	24	675	Hanseniaspora clermontiae NRRL Y-27515
GCA_003706395.1	1618	1614	4	2	86	Danielozyma ontarioensis NRRL YB-1246
GCA_003706415.2	1540	1534	6	18	148	Deakozyma indianensis NRRL YB-1937
GCA_003706445.2	1626	1616	10	8	72	Cyberlindnera mrakii NRRL Y-1364
GCA_003706475.2	1569	1566	3	6	131	Candida corydali NRRL Y-27910
GCA_003706495.1	1653	1639	14	6	47	Cephaloascus albidus NRRL Y-7343
GCA_003706505.2	1635	1634	1	6	65	Suhomyces pyralidae NRRL Y-27085
GCA_003706525.1	1643	1638	5	3	60	Suhomyces canberraensis NRRL YB-2417
GCA_003706535.1	1631	1609	22	4	71	Teunomyces kruisii NRRL Y-17087
GCA_003706565.2	1616	1613	3	8	82	Teunomyces gatunensis NRRL Y-48064
GCA_003706575.1	1635	1631	4	3	68	Teunomyces cretensis NRRL Y-27777
GCA_003706615.2	1599	1593	6	7	100	[Candida] montana NRRL Y-17326
GCA_003706635.1	1567	1565	2	9	130	Ambrosiozyma sp. 'maleeae' NRRL Y-63635
GCA_003706655.2	1607	1600	7	3	96	Barnettozyma californica NRRL Y-17395
GCA_003706665.1	1610	1604	6	4	92	Barnettozyma hawaiiensis NRRL Y-27270
GCA_003706695.2	1520	1514	6	13	173	[Candida] incommunis NRRL Y-17085
GCA_003706705.2	1608	1602	6	7	91	Barnettozyma populi NRRL Y-12728
GCA_003706715.1	1595	1594	1	5	106	Yamadazyma nakazawae NRRL Y-7903
GCA_003706755.2	1586	1572	14	7	113	[Candida] ponderosae NRRL YB-2307
GCA_003706765.2	1630	1625	5	4	72	Wickerhamomyces hampshirensis NRRL YB-4128
GCA_003706775.2	1403	1402	1	20	283	Tortispora starmeri NRRL Y-63665
GCA_003706805.2	1162	1161	1	62	482	Trigonopsis vinaria NRRL Y-5715
GCA_003706815.2	1632	1626	6	5	69	Wickerhamomyces sp. NRRL YB-2243 NRRL YB-2243
GCA_003706855.2	1628	1628	0	5	73	Priceomyces castillae NRRL Y-7501
GCA_003706875.2	1437	1436	1	16	253	Pichia terricola NRRL YB-4310
GCA_003706895.1	1578	1575	3	8	120	[Candida] fragi NRRL Y-17910
GCA_003706915.2	1632	1626	6	8	66	Cyberlindnera petersonii NRRL YB-3808
GCA_003706925.2	1628	1625	3	4	74	Hyphopichia heimii NRRL Y-7502
GCA_003706955.2	1614	1613	1	2	90	[Candida] blattae NRRL Y-27698
GCA_003706965.1	1527	1522	5	13	166	[Candida] hispaniensis NRRL Y-5580
GCA_003706995.2	1593	1591	2	6	107	Yamadazyma philogaea NRRL Y-7813
GCA_003707015.2	1631	1624	7	4	71	Wickerhamomyces canadensis NRRL Y-1888
GCA_003707025.1	1580	1578	2	7	119	Yamadazyma scolyti NRRL Y-5512
GCA_003707035.1	1558	1547	11	16	132	Yarrowia bubula NRRL Y-63668
GCA_003707065.2	1164	1162	2	67	475	Trigonopsis variabilis NRRL Y-1579
GCA_003707085.1	1646	1640	6	4	56	Torulaspora microellipsoides NRRL Y-1549
GCA_003707115.1	1425	1419	6	14	267	Tortispora ganteri NRRL Y-17035
GCA_003707125.2	1632	1630	2	5	69	Meyerozyma caribbica NRRL Y-27274
GCA_003707135.1	1570	1567	3	9	127	Kurtzmaniella cleridarum NRRL Y-48386
GCA_003707165.1	1584	1578	6	11	111	Phaffomyces opuntiae NRRL Y-11707
GCA_003707195.1	1591	1586	5	3	112	Phaffomyces antillensis NRRL Y-12881
GCA_003707205.2	1532	1532	0	8	166	Kregervanrija delftensis NRRL Y-7119
GCA_003707215.1	1589	1585	4	6	111	Phaffomyces thermotolerans NRRL Y-11709
GCA_003707255.1	1389	1387	2	14	303	Saturnispora hagleri NRRL Y-27828
GCA_003707265.1	1561	1559	2	5	140	[Candida] stellimalicola NRRL Y-17912
GCA_003707275.2	1536	1533	3	9	161	Kregervanrija fluxuum NRRL YB-4273
GCA_003707305.1	1390	1389	1	15	301	Saturnispora saitoi NRRL Y-6671
GCA_003707315.2	1339	1339	0	22	345	Saturnispora silvae NRRL Y-6725
GCA_003707355.1	1423	1420	3	9	274	Pichia exigua NRRL Y-10920
GCA_003707375.2	1576	1573	3	6	124	Ogataea populi-albae NRRL Y-48632
GCA_003707405.1	1608	1600	8	12	86	[Candida] schatavii NRRL Y-17078
GCA_003707425.2	1594	1591	3	11	101	[Candida] restingae NRRL Y-27358
GCA_003707435.1	1589	1585	4	7	110	Aciculoconidium aculeatum NRRL YB-4298
GCA_003707445.1	865	864	1	272	569	Botryozyma nematodophila NRRL Y-17705
GCA_003707475.1	1485	1390	95	24	197	Dipodascus albidus NRRL Y-12859
GCA_003707485.2	1592	1581	11	5	109	Blastobotrys proliferans NRRL Y-17577
GCA_003707525.2	1062	1058	4	245	399	Blastobotrys niveus NRRL Y-17581
GCA_003707545.2	1186	1182	4	73	447	Lipomyces oligophaga NRRL Y-17247
GCA_003707555.1	1600	1600	0	7	99	Kluyveromyces aestuarii NRRL YB-4510
GCA_003707585.2	1153	1149	4	93	460	Lipomyces arxii NRRL Y-17921
GCA_003707595.1	1633	1632	1	7	66	Zygosaccharomyces bisporus NRRL Y-12626
GCA_003707605.1	1579	1524	55	2	125	Tetrapisispora fleetii NRRL Y-27350
GCA_003707645.1	1594	1589	5	7	105	Ogataea trehalophila NRRL Y-6781
GCA_003707665.1	1605	1599	6	10	91	Ogataea pini NRRL Y-11528
GCA_003707675.2	1566	1553	13	8	132	Ambrosiozyma philentoma NRRL Y-7523
GCA_003707685.1	1587	1579	8	5	114	Ogataea pilisensis NRRL Y-27598
GCA_003707715.1	1429	1417	12	13	264	Hanseniaspora osmophila NRRL Y-1613
GCA_003707735.1	1646	1639	7	7	53	[Candida] freyschussii NRRL Y-7957A
GCA_003707745.1	1608	1595	13	14	84	Cyberlindnera misumaiensis NRRL Y-17389
GCA_003707785.2	1622	1620	2	4	80	[Candida] oregonensis NRRL Y-5850
GCA_003707795.1	1567	1561	6	15	124	Clavispora fructus NRRL Y-17072
GCA_003707825.2	1652	1648	4	5	49	Cephaloascus fragrans NRRL Y-6742
GCA_003707835.2	1636	1634	2	5	65	Suhomyces emberorum NRRL Y-27606
GCA_003707865.1	1616	1609	7	5	85	Barnettozyma pratensis NRRL Y-12696
GCA_003707885.1	1598	1589	9	10	98	Barnettozyma salicaria NRRL Y-6780
GCA_003707895.2	1579	1574	5	3	124	Ambrosiozyma pseudovanderkliftii NRRL Y-63632
GCA_003707925.2	1572	1565	7	7	127	Zygoascus ofunaensis NRRL Y-10998
GCA_003707935.2	1566	1560	6	13	127	Zygoascus meyerae NRRL Y-17319
GCA_003707945.2	1642	1635	7	5	59	Wickerhamomyces bovis NRRL YB-4184
GCA_003707985.2	1633	1628	5	3	70	Wickerhamomyces alni NRRL Y-11625
GCA_003707995.1	1473	1433	40	10	223	Yueomyces sinensis NRRL Y-17406
GCA_003708045.1	1578	1565	13	5	123	Yarrowia divulgata NRRL Y-63741
GCA_003708055.2	1622	1620	2	8	76	Torulaspora maleeae CBS 10694
GCA_003708085.1	1558	1545	13	6	142	Starmera amethionina NRRL Y-10978
GCA_003708095.2	1389	1388	1	12	305	Saturnispora dispora NRRL Y-1447
GCA_003708105.2	1480	1472	8	16	210	Middelhovenomyces tepae NRRL Y-17670
GCA_003708145.2	1594	1587	7	5	107	[Candida] orba NRRL Y-27336
GCA_003708155.1	1590	1589	1	8	108	Kodamaea ohmeri NRRL Y-1932
GCA_003708185.2	1636	1635	1	3	67	[Candida] rhagii NRRL Y-2594
GCA_003708205.1	1640	1637	3	2	64	[Candida] gotoi NRRL Y-27225
GCA_003708225.2	1626	1618	8	7	73	Cyberlindnera suaveolens NRRL Y-17391
GCA_003708265.2	1625	1617	8	4	77	[Candida] vartiovaarae NRRL Y-6701
GCA_003708285.1	1637	1622	15	6	63	Cyberlindnera xylosilytica NRRL YB-2097
GCA_003708295.2	1633	1628	5	5	68	[Candida] mycetangii NRRL Y-6843
GCA_003708315.2	1541	1535	6	11	154	Groenewaldozyma salmanticensis NRRL Y-17090
GCA_003708335.1	1023	1021	2	18	665	Hanseniaspora pseudoguilliermondii ZIM213 Neza Cadez
GCA_003708355.2	1598	1593	5	16	92	Cyberlindnera maclurae NRRL Y-5377
GCA_003708365.1	992	991	1	24	690	Hanseniaspora sp. 'singularis' ZIM2326 Neza Cadez; ST-244
GCA_003708405.1	1584	1579	5	8	114	[Candida] heveicola NRRL Y-48716
GCA_003708425.2	1585	1525	60	8	113	Kazachstania rosinii NRRL Y-17919
GCA_003708445.2	1491	1458	33	9	206	Kazachstania transvaalensis NRRL Y-17245
GCA_003708455.1	1552	1454	98	1	153	Kazachstania viticola NRRL Y-27206
GCA_003708465.1	1573	1499	74	6	127	Kazachstania kunashirensis NRRL Y-27209
GCA_003708495.1	1519	1479	40	20	167	Kazachstania aerobia NRRL Y-27976
GCA_003708525.2	1548	1508	40	11	147	Kazachstania unispora NRRL Y-1556
GCA_003708535.2	1598	1534	64	3	105	Kazachstania bromeliacearum NRRL Y-48836
GCA_003708545.1	1555	1495	60	7	144	Kazachstania turicensis NRRL Y-48834
GCA_003708585.1	1652	1647	5	0	54	Debaryomyces nepalensis NRRL Y-7108
GCA_003708605.2	1653	1650	3	3	50	Debaryomyces maramus NRRL Y-2171
GCA_003708615.1	1583	1582	1	9	114	[Candida] hawaiiana NRRL Y-27473
GCA_003708635.2	1497	1194	303	13	196	Magnusiomyces tetraspermus NRRL Y-7288 NRRL Y-7288
GCA_003708655.1	1492	1393	99	24	190	Dipodascus geniculatus NRRL Y-17628
GCA_003708665.2	1670	1666	4	2	34	Debaryomyces fabryi NRRL Y-17914
GCA_003708705.1	1595	1593	2	3	108	[Candida] tammaniensis NRRL Y-8257
GCA_003708715.2	1585	1584	1	5	116	[Candida] wancherniae NRRL Y-48709
GCA_003708745.2	1560	1558	2	6	140	[Candida] ascalaphidarum NRRL Y-27908
GCA_003708755.1	1564	1564	0	10	132	[Candida] golubevii NRRL Y-48707
GCA_003708765.1	1019	1015	4	21	666	Hanseniaspora sp. 'hatyaiensis' ZIM2327 Neza Cadez; ST-476
GCA_003708795.2	1635	1631	4	6	65	Cyberlindnera americana NRRL Y-2156
GCA_003708825.2	1585	1503	82	3	118	Kazachstania spencerorum NRRL Y-17920
GCA_003708835.2	1534	1488	46	12	160	Kazachstania solicola NRRL Y-27207
GCA_003708845.2	1557	1513	44	12	137	Kazachstania intestinalis NRRL Y-48847
GCA_003708865.1	1533	1494	39	14	159	Kazachstania taianensis NRRL Y-48846
GCA_003708905.2	1550	1511	39	11	145	Kazachstania siamensis NRRL Y-48842
GCA_003708925.2	1567	1490	77	11	128	Kazachstania martiniae NRRL Y-409
GCA_003708935.1	1658	1647	11	1	47	Debaryomyces prosopidis NRRL Y-27369
GCA_003708965.1	1666	1662	4	1	39	Debaryomyces subglobosus NRRL Y-6666
GCA_003708985.2	1583	1580	3	6	117	[Candida] gorgasii NRRL Y-27707
GCA_003709205.2	1605	1599	6	5	96	Ogataea zsoltii NRRL Y-27601
GCA_003709225.2	1630	1630	0	4	72	Priceomyces carsonii NRRL YB-4275
GCA_003709245.2	1625	1613	12	8	73	Cyberlindnera saturnus NRRL Y-17396
GCA_003709265.1	1489	1457	32	8	209	Kazachstania yakushimaensis NRRL Y-48837
GCA_003709285.1	1627	1546	81	3	76	Saccharomyces cerevisiae KSD-Yc
GCA_003719635.1	1528	1460	68	18	160	Saccharomyces cerevisiae Y169
GCA_003719665.1	1446	1388	58	47	213	Saccharomyces cerevisiae X55
GCA_003856775.1	1623	1619	4	5	78	Hyphopichia pseudoburtonii
GCA_003856795.1	1557	1553	4	15	134	Hyphopichia burtonii
GCA_004014935.1	1509	1498	11	10	187	Saccharomycopsis malanga KCN26
GCA_004114265.1	1630	1552	78	3	73	Saccharomyces cerevisiae SA1
GCA_004124885.1	1186	1184	2	35	485	Starmerella bombicola NRRL Y-17069
GCA_004124915.1	1231	1227	4	35	440	Starmerella kuoi NRRL Y-27208
GCA_004124955.1	1066	1064	2	77	563	Starmerella riodocensis NRRL Y-27859
GCA_004124965.1	1179	1177	2	34	493	Starmerella apicola NRRL Y-2481
GCA_004124975.1	1108	1101	7	62	536	Starmerella ratchasimensis CBS 10611
GCA_004124985.1	1003	1000	3	66	637	Starmerella davenportii CBS 9069
GCA_004125005.1	1143	1140	3	60	503	Starmerella sorbosivorans CBS 8768
GCA_004125055.1	1205	1201	4	57	444	Starmerella sp. 'tilneyi' CBS 8794
GCA_004125065.1	1266	1256	10	30	410	Wickerhamiella versatilis NRRL Y-6652
GCA_004125075.1	702	701	1	257	747	Starmerella gropengiesseri NRRL Y-17142
GCA_004125095.1	1304	1301	3	27	375	Wickerhamiella occidentalis NRRL Y-27364
GCA_004125105.1	1426	1419	7	19	261	Wickerhamiella hasegawae JCM 12559
GCA_004125145.1	1431	1423	8	15	260	Wickerhamiella infanticola NRRL Y-17858
GCA_004125165.1	1139	1138	1	71	496	Starmerella geochares NRRL Y-17073
GCA_004125175.1	1223	1221	2	44	439	Wickerhamiella domercqiae NRRL Y-6692
GCA_004125185.1	1209	1207	2	37	460	Starmerella vaccinii NRRL Y-17684
GCA_004125235.1	1175	1172	3	83	448	Wickerhamiella pararugosa NRRL Y-17089
GCA_004138035.1	1548	1479	69	25	133	Saccharomyces cerevisiae 222-1B-D1606
GCA_004195225.1	1524	1519	5	19	163	Cyberlindnera fabianii Ex2
GCA_004217705.1	1582	1580	2	10	114	Metschnikowia aff. pulcherrima APC 1.2
GCA_004287075.1	1591	1590	1	10	105	[Candida] auris RCPF-1821
GCA_004328465.1	1627	1544	83	4	75	Saccharomyces cerevisiae ySR128
GCA_004332445.1	1596	1559	37	7	103	[Candida] glabrata 44
GCA_004332455.1	1596	1561	35	9	101	[Candida] glabrata 40
GCA_004332465.1	1598	1562	36	6	102	[Candida] glabrata OL152
GCA_004334915.1	1561	1557	4	12	133	Candida orthopsilosis Co 90-125 Co 90-125
GCA_004352945.1	1622	1540	82	7	77	Saccharomyces paradoxus R23
GCA_004352955.1	1616	1533	83	6	84	Saccharomyces paradoxus WX20
GCA_004352965.1	1622	1538	84	6	78	Saccharomyces paradoxus LL2012_001
GCA_004353035.1	1620	1535	85	5	81	Saccharomyces paradoxus LL2012_016
GCA_004353095.1	1620	1534	86	6	80	Saccharomyces paradoxus LL2011_012
GCA_004353105.1	1620	1536	84	9	77	Saccharomyces paradoxus MSH-604
GCA_004359125.1	1610	1533	77	7	89	Saccharomyces cerevisiae IR-2idA30a
GCA_004919595.1	1590	1589	1	8	108	Kodamaea ohmeri
GCA_004919765.1	1004	996	8	28	674	Hanseniaspora lachancei NRRL Y-27514
GCA_004919775.1	1021	1019	2	18	667	Hanseniaspora guilliermondii NRRL Y-1625
GCA_004919785.1	952	788	164	31	723	Hanseniaspora jakobsenii ZIM 2603
GCA_004919795.1	1017	1015	2	24	665	Hanseniaspora sp. CRUB 1602 CRUB 1602
GCA_004919825.1	996	932	64	21	689	Hanseniaspora meyeri NRRL Y-27513
GCA_004919845.1	987	923	64	37	682	Hanseniaspora nectarophila CBS 13383
GCA_004919885.1	1409	1362	47	17	280	Hanseniaspora occidentalis var. citrica CBS 6783
GCA_004919895.1	1384	1378	6	18	304	Hanseniaspora occidentalis var. occidentalis NRRL Y-7946
GCA_004919915.1	985	961	24	31	690	Hanseniaspora thailandica ZIM 2325
GCA_004919925.1	1016	1013	3	12	678	Hanseniaspora uvarum NRRL Y-1614
GCA_004919945.1	1327	1323	4	52	327	Hanseniaspora vineae NRRL Y-17529
GCA_004931855.1	1410	1409	1	18	278	[Candida] inconspicua CBS 180
GCA_005234155.1	1308	1307	1	47	351	[Candida] auris LOM
GCA_005406065.1	1471	1469	2	21	214	Metschnikowia sp. JCM 33374 JCM 33374
GCA_005406105.1	1621	1620	1	6	79	Zygosaccharomyces mellis Ca-7
GCA_005406165.1	1470	1467	3	10	226	Pichia manshurica YM63
GCA_005890685.1	1459	1450	9	18	229	Candida albicans NCYC 4145
GCA_005890695.1	1326	1316	10	18	362	Candida albicans NCYC 4144
GCA_005890705.1	1401	1391	10	26	279	Candida albicans NCYC 4146
GCA_005890745.1	1604	1589	15	9	93	Candida albicans NCYC 4146
GCA_005890765.1	1597	1591	6	3	106	Candida albicans NCYC 4144
GCA_005890775.1	1594	1583	11	9	103	Candida albicans NCYC 4145
GCA_006942115.1	1621	1617	4	6	79	Scheffersomyces stipitis CBS 6054 CBS 6054
GCA_006942135.1	1510	1499	11	14	182	Candida tropicalis MYA-3404 MYA-3404
GCA_006942155.1	1612	1608	4	11	83	Meyerozyma guilliermondii ATCC 6260 ATCC 6260
GCA_006942205.1	1667	1662	5	3	36	Debaryomyces hansenii J26
GCA_006942215.1	1670	1665	5	3	33	Debaryomyces hansenii NRRL YB-398
GCA_006942225.1	1670	1665	5	1	35	Debaryomyces hansenii NRRL Y-17914
GCA_006942235.1	1668	1663	5	2	36	Debaryomyces hansenii NRRL Y-7426
GCA_006942305.1	1672	1667	5	2	32	Debaryomyces hansenii NRRL Y-1449
GCA_006942325.1	1669	1662	7	4	33	Debaryomyces hansenii NRRL YB-155
GCA_007168705.1	1597	1596	1	6	103	[Candida] auris JCM 15448
GCA_007556415.1	1532	1429	103	24	150	Saccharomyces cerevisiae NRRL Y-567
GCA_007556495.1	1627	135	1492	4	75	Zygosaccharomyces mellis
GCA_007844265.1	1573	1564	9	5	128	Yarrowia galli HXPF_0137
GCA_008000265.1	1601	1600	1	6	99	Kluyveromyces marxianus L03
GCA_008000345.1	1618	1614	4	11	77	Meyerozyma guilliermondii RP-YS-11
GCA_008062615.1	1631	1628	3	9	66	Meyerozyma guilliermondii SO
GCA_008065175.1	1556	1556	0	7	143	Metschnikowia caudata EBD-CdVSA57-2
GCA_008065185.1	1562	1562	0	6	138	Metschnikowia caudata EBD-CdVSA08-1
GCA_008065195.1	1577	1576	1	12	117	Metschnikowia amazonensis UFMG-CM-6309
GCA_008065205.1	1578	1577	1	12	116	Metschnikowia amazonensis UFMG-CM-6307
GCA_008065245.1	1591	1591	0	6	109	Metschnikowia agaves UWOPS 92-207.1
GCA_008065255.1	1586	1586	0	8	112	Metschnikowia agaves UWOPS 92-210.1
GCA_008275145.1	1484	1483	1	28	194	[Candida] auris B11245
GCA_008704595.1	1466	1463	3	17	223	Diutina rugosa CBS 613
GCA_008704605.1	1605	1593	12	4	97	Trichomonascus ciferrii CBS 4856
GCA_008729165.1	1600	1599	1	6	100	[Candida] auris 288
GCA_008729175.1	1599	1598	1	5	102	[Candida] auris 214
GCA_008729195.1	1597	1596	1	6	103	[Candida] auris 394-1
GCA_008729205.1	1599	1598	1	6	101	[Candida] auris 367
GCA_008729255.1	1596	1595	1	7	103	[Candida] auris 394-2
GCA_008729275.1	1593	1592	1	7	106	[Candida] auris 394-3
GCA_008764215.1	1605	1602	3	4	97	Candida parapsilosis DE0235
GCA_008802755.1	1536	1502	34	12	158	Kazachstania servazzii UCD335
GCA_008802765.1	1537	1501	36	10	159	Kazachstania servazzii UCD13
GCA_008904905.1	1274	1242	32	58	374	Candida metapsilosis ATCC 96143
GCA_008973615.1	1601	1601	0	8	97	Kluyveromyces sp. TMB-2019a UFMG-CM-Y3682
GCA_009014655.1	1615	1537	78	10	81	Saccharomyces cerevisiae Pf-1
GCA_009194645.1	1582	1573	9	7	117	Yarrowia lipolytica YlCW001
GCA_009281745.1	1634	1629	5	6	66	Cyberlindnera americana ChDrAdgY46
GCA_009372015.1	1583	1575	8	7	116	Yarrowia lipolytica PO1f
GCA_009394695.1	1528	1502	26	6	172	Kazachstania telluris UCD400
GCA_009498055.1	1602	1599	3	7	97	Clavispora lusitaniae P1
GCA_009498075.1	1599	1596	3	7	100	Clavispora lusitaniae P2
GCA_009498095.1	1600	1591	9	7	99	Clavispora lusitaniae P3
GCA_009498115.1	1600	1591	9	7	99	Clavispora lusitaniae P5
GCA_009498135.1	1600	1597	3	7	99	Clavispora lusitaniae P4
GCA_009602605.1	1602	1601	1	7	97	[Candida] auris CA_HTX1
GCA_009663155.1	0	0	0	9	1697	Saccharomyces cerevisiae YAF155
GCA_009663225.1	16	16	0	132	1558	Saccharomyces cerevisiae YAF129
GCA_009663235.1	126	125	1	299	1281	Saccharomyces cerevisiae YAF140
GCA_009663245.1	2	2	0	58	1646	Saccharomyces cerevisiae YAF153
GCA_009663275.1	1595	1507	88	8	103	Saccharomyces cerevisiae YAF064
GCA_009663385.1	254	242	12	327	1125	Saccharomyces cerevisiae YAF019
GCA_009664425.1	5	5	0	90	1611	Saccharomyces cerevisiae YAF156
GCA_009665535.1	1625	738	887	6	75	Saccharomyces cerevisiae x Saccharomyces kudriavzevii yHCT142
GCA_009665545.1	1628	1397	231	8	70	Saccharomyces cerevisiae x Saccharomyces kudriavzevii FM64
GCA_009665555.1	1635	214	1421	6	65	Saccharomyces cerevisiae x Saccharomyces eubayanus yHQL630
GCA_009665565.1	1633	211	1422	8	65	Saccharomyces cerevisiae x Saccharomyces eubayanus yHCT145
GCA_009665575.1	1626	297	1329	11	69	Saccharomyces cerevisiae x Saccharomyces eubayanus yHDD49
GCA_009665625.1	1630	292	1338	6	70	Saccharomyces cerevisiae x Saccharomyces eubayanus yHAB213
GCA_009665675.1	1629	275	1354	7	70	Saccharomyces cerevisiae x Saccharomyces eubayanus yHAB25
GCA_009665685.1	1634	214	1420	7	65	Saccharomyces cerevisiae x Saccharomyces eubayanus yHQL629
GCA_009665705.1	1631	202	1429	7	68	Saccharomyces cerevisiae x Saccharomyces eubayanus yHQL628
GCA_009665725.1	1629	209	1420	8	69	Saccharomyces cerevisiae x Saccharomyces eubayanus yHAB28
GCA_009665755.1	1627	288	1339	12	67	Saccharomyces cerevisiae x Saccharomyces eubayanus yHCT135
GCA_009665795.1	1634	249	1385	5	67	Saccharomyces cerevisiae x Saccharomyces eubayanus yHQL627
GCA_009665865.1	1634	210	1424	6	66	Saccharomyces cerevisiae x Saccharomyces eubayanus yHQL626
GCA_009665875.1	1633	312	1321	6	67	Saccharomyces cerevisiae x Saccharomyces eubayanus yHQL625
GCA_009665895.1	1598	275	1323	6	102	Saccharomyces cerevisiae x Saccharomyces eubayanus yHCT134
GCA_009665905.1	1636	203	1433	3	67	Saccharomyces cerevisiae x Saccharomyces eubayanus yHQL624
GCA_009665985.1	1627	727	900	8	71	Saccharomyces cerevisiae x Saccharomyces kudriavzevii yHQL621
GCA_009665995.1	1630	216	1414	7	69	Saccharomyces cerevisiae x Saccharomyces eubayanus yHQL620
GCA_009666015.1	1631	200	1431	7	68	Saccharomyces cerevisiae x Saccharomyces eubayanus yHAB589
GCA_009666025.1	1633	243	1390	7	66	Saccharomyces cerevisiae x Saccharomyces eubayanus yHQL618
GCA_009666085.1	1614	243	1371	6	86	Saccharomyces cerevisiae x Saccharomyces eubayanus yHAB37
GCA_009666095.1	1609	323	1286	24	73	Saccharomyces cerevisiae x Saccharomyces eubayanus yHQL617
GCA_009666115.1	1630	200	1430	8	68	Saccharomyces cerevisiae x Saccharomyces eubayanus yHAB53
GCA_009666145.1	1627	238	1389	11	68	Saccharomyces cerevisiae x Saccharomyces eubayanus yHAB50
GCA_009666185.1	1634	215	1419	6	66	Saccharomyces cerevisiae x Saccharomyces eubayanus yHQL616
GCA_009666195.1	1632	229	1403	8	66	Saccharomyces cerevisiae x Saccharomyces eubayanus yHCT131
GCA_009666255.1	1633	219	1414	8	65	Saccharomyces cerevisiae x Saccharomyces eubayanus yHAB32
GCA_009666265.1	1624	765	859	7	75	Saccharomyces cerevisiae x Saccharomyces kudriavzevii yHAB44
GCA_009666275.1	1632	182	1450	3	71	Saccharomyces cerevisiae x Saccharomyces eubayanus x Saccharomyces uvarum yHAB34
GCA_009666335.1	1626	1543	83	7	73	Saccharomyces eubayanus x Saccharomyces uvarum yHQL522
GCA_009666355.1	1602	221	1381	3	101	Saccharomyces cerevisiae x Saccharomyces eubayanus yHCT132
GCA_009666385.1	1632	1548	84	5	69	Saccharomyces eubayanus x Saccharomyces uvarum yHQL555
GCA_009666405.1	1622	510	1112	12	72	Saccharomyces eubayanus x Saccharomyces uvarum yHQL554
GCA_009666445.1	1627	1155	472	4	75	Saccharomyces eubayanus x Saccharomyces uvarum yHQL561
GCA_009666465.1	1635	131	1504	4	67	Saccharomyces cerevisiae x Saccharomyces kudriavzevii x Saccharomyces eubayanus yHQL560
GCA_009666475.1	1619	1040	579	10	77	Saccharomyces eubayanus x Saccharomyces uvarum yHQL559
GCA_009666495.1	1640	198	1442	2	64	Saccharomyces cerevisiae x Saccharomyces eubayanus x Saccharomyces kudriavzevii x Saccharomyces uvarum yHQL557
GCA_009666535.1	1589	1374	215	30	87	Saccharomyces eubayanus x Saccharomyces uvarum yHQL556
GCA_009666575.1	1632	245	1387	5	69	Saccharomyces cerevisiae x Saccharomyces eubayanus yHQL582
GCA_009666585.1	1629	1146	483	7	70	Saccharomyces eubayanus x Saccharomyces uvarum yHQL581
GCA_009666635.1	1632	207	1425	7	67	Saccharomyces cerevisiae x Saccharomyces eubayanus yHQL619
GCA_009666655.1	1630	274	1356	7	69	Saccharomyces cerevisiae x Saccharomyces eubayanus yHAB38
GCA_009666665.1	1633	243	1390	5	68	Saccharomyces cerevisiae x Saccharomyces eubayanus yHAB585
GCA_009666725.1	1629	223	1406	9	68	Saccharomyces cerevisiae x Saccharomyces eubayanus yHAB36
GCA_009666755.1	1619	1538	81	11	76	Saccharomyces eubayanus x Saccharomyces uvarum yHQL570
GCA_009666765.1	1379	705	674	108	219	Saccharomyces eubayanus x Saccharomyces uvarum yHQL558
GCA_009666845.1	1609	592	1017	13	84	Saccharomyces eubayanus x Saccharomyces uvarum yHQL573
GCA_009666865.1	1607	1036	571	13	86	Saccharomyces eubayanus x Saccharomyces uvarum yHQL569
GCA_009666875.1	1624	215	1409	14	68	Saccharomyces cerevisiae x Saccharomyces eubayanus x Saccharomyces kudriavzevii x Saccharomyces uvarum yHQL568
GCA_009666905.1	1629	1304	325	7	70	Saccharomyces eubayanus x Saccharomyces uvarum yHQL567
GCA_009666955.1	1608	1339	269	13	85	Saccharomyces eubayanus x Saccharomyces uvarum yHQL566
GCA_009666965.1	1628	123	1505	7	71	Saccharomyces eubayanus x Saccharomyces uvarum yHQL565
GCA_009667045.1	1619	1538	81	11	76	Saccharomyces eubayanus x Saccharomyces uvarum yHQL564
GCA_009667055.1	1642	89	1553	3	61	Saccharomyces cerevisiae x Saccharomyces eubayanus x Saccharomyces kudriavzevii x Saccharomyces uvarum yHQL563
GCA_009667075.1	1618	763	855	11	77	Saccharomyces eubayanus x Saccharomyces uvarum yHQL580
GCA_009667125.1	1626	577	1049	6	74	Saccharomyces cerevisiae x Saccharomyces eubayanus FM471
GCA_009667145.1	1499	1433	66	4	203	Saccharomyces eubayanus x Saccharomyces uvarum yHQL572
GCA_009667195.1	1612	1406	206	4	90	Saccharomyces eubayanus x Saccharomyces uvarum FM473
GCA_009667215.1	1636	375	1261	7	63	Saccharomyces cerevisiae x Saccharomyces eubayanus yHCT111
GCA_009667225.1	1628	1118	510	3	75	Saccharomyces cerevisiae x Saccharomyces eubayanus FM1203
GCA_009667275.1	1625	1542	83	7	74	Saccharomyces eubayanus x Saccharomyces uvarum yHCT110
GCA_009667295.1	1633	202	1431	5	68	Saccharomyces cerevisiae x Saccharomyces eubayanus yHCT133
GCA_009667335.1	1635	399	1236	5	66	Saccharomyces cerevisiae x Saccharomyces eubayanus yHCT80
GCA_009667345.1	1633	454	1179	6	67	Saccharomyces cerevisiae x Saccharomyces eubayanus yHCT79
GCA_009667385.1	1622	1526	96	5	79	Saccharomyces eubayanus x Saccharomyces uvarum yHQL562
GCA_009667415.1	1641	382	1259	0	65	Saccharomyces cerevisiae x Saccharomyces kudriavzevii W27
GCA_009667515.1	1626	863	763	7	73	Saccharomyces cerevisiae x Saccharomyces eubayanus yHCT83
GCA_009667545.1	1630	771	859	5	71	Saccharomyces cerevisiae x Saccharomyces kudriavzevii yHQL783
GCA_009707815.1	1486	1454	32	8	212	Wickerhamomyces anomalus LBCM1105
GCA_009738405.1	796	768	28	206	704	Saccharomyces cerevisiae SK23
GCA_009746055.1	1580	657	923	10	116	Metschnikowia citriensis FL01
GCA_009756405.1	1625	1622	3	9	72	Meyerozyma guilliermondii YLG18
GCA_009756535.1	1564	1562	2	10	132	Metschnikowia sp. UFMG-CM-y6306 UFMG-CM-y6306
GCA_009756545.1	1554	1552	2	13	139	Metschnikowia dekortorum UWOPS 01-522a5
GCA_009756565.1	1561	1559	2	12	133	Metschnikowia sp. UWOPS 03-167b3 UWOPS 03-167b3
GCA_009756645.1	1561	1558	3	10	135	Metschnikowia sp. UWOPS 12.619.2 UWOPS 12.619.2
GCA_009805625.1	1631	1547	84	4	71	Saccharomyces cerevisiae YPS128
GCA_009805645.1	1627	1542	85	4	75	Saccharomyces paradoxus CBS 432
GCA_009805665.1	1620	1538	82	6	80	Saccharomyces cerevisiae RM11-1a
GCA_009805715.1	1003	1001	2	20	683	Hanseniaspora uvarum H4
GCA_009805765.1	1015	1012	3	13	678	Hanseniaspora uvarum H20
GCA_009805785.1	1016	1013	3	12	678	Hanseniaspora uvarum H2
GCA_009932455.1	1426	1187	239	55	225	Metschnikowia pulcherrima Bath1
GCA_010111755.1	1600	1562	38	4	102	[Candida] glabrata ATCC 2001
GCA_010356925.1	1625	1543	82	6	75	Saccharomyces cerevisiae INSC1005
GCA_010356935.1	1628	1544	84	5	73	Saccharomyces cerevisiae INSC1006
GCA_010994365.1	1395	1382	13	16	295	Saccharomycopsis schoenii CBS 7425
GCA_010994405.1	1510	1496	14	9	187	Saccharomycopsis crataegensis CBS 6447
GCA_011022315.1	1632	259	1373	4	70	Saccharomyces pastorianus CBS 1483
GCA_011037055.1	1618	1605	13	3	85	Candida albicans H892
GCA_011074765.1	1448	1442	6	15	243	Brettanomyces custersianus CBS 4805
GCA_011074775.1	1531	1524	7	10	165	Brettanomyces naardenensis CBS 6042
GCA_011074815.1	1397	1381	16	32	277	Brettanomyces anomalus CBS 8139
GCA_011074865.2	1515	1510	5	10	181	Brettanomyces nanus CBS 1945
GCA_011074885.1	1477	1472	5	7	222	Brettanomyces bruxellensis UCD 2041
GCA_011316035.2	1528	1523	5	12	166	Candida parapsilosis 90-137
GCA_011316215.1	1627	1548	79	2	77	Saccharomyces cerevisiae KCCM51299
GCA_011393095.1	667	661	6	292	747	Saccharomyces cerevisiae YJM428 YJM428
GCA_011393105.1	1572	1506	66	11	123	Saccharomyces cerevisiae YJM280 YJM280
GCA_011393115.1	1518	1471	47	36	152	Saccharomyces cerevisiae WE372 WE372
GCA_011393125.1	1095	1068	27	134	477	Saccharomyces cerevisiae Y9 Y9
GCA_011393135.1	1617	1537	80	5	84	Saccharomyces cerevisiae YJM320 YJM320
GCA_011393155.1	1486	1426	60	35	185	Saccharomyces cerevisiae YJM653 YJM653
GCA_011393185.1	1585	1514	71	15	106	Saccharomyces cerevisiae YJM326 YJM326
GCA_011393195.1	1609	1540	69	8	89	Saccharomyces cerevisiae I14 I14
GCA_011393215.1	1492	1444	48	40	174	Saccharomyces cerevisiae YPS1009 YPS1009
GCA_011393235.1	1629	1546	83	5	72	Saccharomyces cerevisiae YJM421 YJM421
GCA_011393275.1	1628	1547	81	3	75	Saccharomyces cerevisiae Y12 Y12
GCA_011420275.1	1590	1436	154	11	105	Geotrichum candidum B1101
GCA_011426285.1	1596	1595	1	5	105	[Candida] haemuloni BMU05228
GCA_011426315.1	1585	1580	5	4	117	[Candida] duobushaemulonis BMU05314
GCA_011751505.1	1420	1419	1	15	271	Tortispora sangerardonensis UWOPS 00-157.1
GCA_011799815.1	1600	1523	77	8	98	Saccharomyces cerevisiae Jean-Talon
GCA_012062855.1	1525	1501	24	9	172	Saccharomycopsis fibuligera MBY1320
GCA_012184645.1	1597	1595	2	5	104	[Candida] haemuloni var. vulnera K1
GCA_012184655.1	1599	1597	2	5	102	[Candida] haemuloni var. vulnera K2
GCA_012275245.1	1594	1404	190	12	100	Saccharomyces cerevisiae FDAARGOS_613
GCA_012295335.1	1475	1470	5	8	223	Brettanomyces custersianus CRL-53
GCA_012295355.1	1542	1536	6	7	157	Brettanomyces naardenensis CRL-65
GCA_012295365.1	1218	1211	7	42	446	Brettanomyces anomalus CRL-49
GCA_012295375.1	1411	1306	105	24	271	Brettanomyces bruxellensis CRL-50
GCA_012654145.1	1584	1575	9	6	116	Yarrowia lipolytica W29
GCA_012850905.1	1616	1528	88	2	88	Naumovozyma castellii Y668
GCA_012850925.1	1619	1527	92	0	87	Naumovozyma castellii Y287
GCA_012850935.1	1610	1521	89	5	91	Naumovozyma castellii Y174
GCA_012850965.1	1611	1517	94	7	88	Naumovozyma castellii Y056
GCA_012851005.1	1632	1630	2	4	70	Torulaspora pretoriensis UWOPS 83-1046.2
GCA_012851035.1	1622	1621	1	8	76	Torulaspora pretoriensis CBS 11123
GCA_012851045.1	1625	1624	1	9	72	Torulaspora pretoriensis CBS 11124
GCA_012851065.1	1622	1621	1	8	76	Torulaspora pretoriensis CBS 11121
GCA_012851095.1	1625	1624	1	9	72	Torulaspora pretoriensis CBS 11100
GCA_012851105.1	1631	1629	2	5	70	Torulaspora pretoriensis CBS 9333
GCA_012851155.1	1627	1625	2	10	69	Torulaspora pretoriensis CBS 5080
GCA_012851165.1	1633	1632	1	5	68	Torulaspora delbrueckii NCYC696
GCA_012851195.1	1632	1630	2	8	66	Torulaspora pretoriensis CBS 2785
GCA_012851205.1	1632	1630	2	4	70	Torulaspora pretoriensis CBS 2187
GCA_012851235.1	1632	1630	2	5	69	Torulaspora delbrueckii L20
GCA_012851245.1	1634	1632	2	5	67	Torulaspora delbrueckii L19
GCA_012851265.1	1636	1635	1	5	65	Torulaspora delbrueckii L16
GCA_012851275.1	1637	1636	1	5	64	Torulaspora delbrueckii L18
GCA_012851295.1	1632	1630	2	5	69	Torulaspora delbrueckii L15
GCA_012851345.1	1628	1627	1	4	74	Torulaspora delbrueckii L13
GCA_012851365.1	1633	1632	1	6	67	Torulaspora delbrueckii L12
GCA_012851405.1	1633	1632	1	6	67	Torulaspora delbrueckii L09
GCA_012851425.1	1627	1625	2	5	74	Torulaspora delbrueckii L11
GCA_012851435.1	1633	1632	1	6	67	Torulaspora delbrueckii L10
GCA_013047185.1	1622	1547	75	6	78	Saccharomyces cerevisiae YJM451 YJM451
GCA_013177575.1	1575	1554	21	2	129	Candida sojae NCYC-2607
GCA_013179775.1	1587	254	1333	5	114	Saccharomyces pastorianus CBS 1483
GCA_013179785.1	1254	1217	37	193	259	Saccharomyces uvarum ZP 646
GCA_013179815.1	1620	1552	68	14	72	Saccharomyces uvarum ZP 853
GCA_013179845.1	1627	228	1399	9	70	Saccharomyces pastorianus W34/70
GCA_013179855.1	1495	1435	60	66	145	Saccharomyces uvarum SAUV_RC415
GCA_013179865.1	1624	212	1412	8	74	Saccharomyces pastorianus Weihenstephan 34/70 Weihenstephan 34/70
GCA_013179935.1	1451	1389	62	84	171	Saccharomyces uvarum SAUV_PM12
GCA_013179955.1	1626	1559	67	9	71	Saccharomyces uvarum PJS 9
GCA_013179965.1	1584	1531	53	22	100	Saccharomyces uvarum PJS 2-95
GCA_013180005.1	1623	1538	85	10	73	Saccharomyces uvarum SAUV_PJP3
GCA_013180045.1	1625	1506	119	9	72	Saccharomyces cerevisiae AWRI2880
GCA_013180055.1	1620	1555	65	10	76	Saccharomyces uvarum NCAIM 01116
GCA_013180065.1	1618	1507	111	10	78	Saccharomyces bayanus NCAIM 676
GCA_013180125.1	1501	1431	70	3	202	Saccharomyces bayanus NBRC1948 NBRC1948
GCA_013180165.1	1630	1547	83	3	73	Saccharomyces bayanus FM1309
GCA_013180185.1	1636	151	1485	3	67	Saccharomyces cerevisiae x Saccharomyces uvarum Muri
GCA_013180195.1	1624	1558	66	11	71	Saccharomyces uvarum M 488
GCA_013180235.1	1630	1550	80	8	68	Saccharomyces uvarum GM 14
GCA_013180255.1	1628	1554	74	7	71	Saccharomyces uvarum DBVPG 7787
GCA_013180345.1	1620	1555	65	12	74	Saccharomyces uvarum DBVPG 7786
GCA_013180355.1	1626	158	1468	4	76	Saccharomyces pastorianus CBS 5832
GCA_013180645.1	1547	1083	464	64	95	Saccharomyces pastorianus DBVPG 6261i
GCA_013180665.1	1617	317	1300	18	71	Saccharomyces cerevisiae x Saccharomyces kudriavzevii x Saccharomyces uvarum CID 1
GCA_013180675.1	1566	1307	259	4	136	Saccharomyces bayanus CBS 380
GCA_013180695.1	1402	1369	33	109	195	Saccharomyces bayanus CBS 380
GCA_013180725.1	1579	348	1231	4	123	Saccharomyces cerevisiae x Saccharomyces kudriavzevii x Saccharomyces uvarum CBS 2834
GCA_013180735.1	1630	211	1419	7	69	Saccharomyces pastorianus CBS 2156
GCA_013180745.1	1615	1455	160	8	83	Saccharomyces pastorianus CBS 2440
GCA_013180785.1	1630	617	1013	3	73	Saccharomyces pastorianus CBS 1513
GCA_013180795.1	1572	291	1281	8	126	Saccharomyces pastorianus CBS 1513 CBS 1513
GCA_013181305.1	1579	1369	210	34	93	Saccharomyces cerevisiae AWRI2911
GCA_013181335.1	1624	1542	82	4	78	Saccharomyces pastorianus CBS 1538
GCA_013181375.1	1636	424	1212	4	66	Saccharomyces pastorianus CBS 1484
GCA_013181485.1	1625	251	1374	7	74	Saccharomyces pastorianus CBS 1483
GCA_013181515.1	1633	218	1415	5	68	Saccharomyces pastorianus CBS 1483
GCA_013183815.1	1595	1455	140	5	106	Saccharomyces pastorianus CBS 1503 CBS 1503
GCA_013183905.1	1627	1152	475	8	71	Saccharomyces cerevisiae AWRI1430
GCA_013265705.1	1578	1515	63	23	105	Saccharomyces uvarum NCAIM 00868
GCA_013265745.1	1562	1495	67	45	99	Saccharomyces uvarum 148.01
GCA_013265755.1	1573	858	715	48	85	Saccharomyces pastorianus DBVPG 6033i
GCA_013265775.1	1620	1557	63	13	73	Saccharomyces uvarum CBS 377
GCA_013305595.1	1596	1441	155	8	102	Geotrichum candidum LMA-317
GCA_013305805.1	1592	1444	148	9	105	Geotrichum candidum LMA-1147
GCA_013305925.1	1593	1446	147	8	105	Galactomyces reessii LMA-1148
GCA_013365045.1	1588	1440	148	12	106	Geotrichum candidum LMA-244
GCA_013365065.1	1592	1435	157	12	102	Geotrichum candidum LMA-1028
GCA_013365075.1	1589	1432	157	11	106	Geotrichum candidum LMA-77
GCA_013365125.1	1589	1432	157	12	105	Geotrichum candidum LMA-70
GCA_013368535.1	1564	1546	18	9	133	Candida theae
GCA_013368665.1	495	487	8	355	856	Saccharomyces cerevisiae NC-02 NC-02
GCA_013368685.1	975	956	19	226	505	Saccharomyces cerevisiae IL-01 IL-01
GCA_013387355.1	1629	1626	3	7	70	Torulaspora franciscae CBS 2926
GCA_013402915.1	1630	1629	1	4	72	Zygotorulaspora mrakii NRRL Y-6702
GCA_013423405.1	1623	1621	2	5	78	Zygosaccharomyces siamensis MinabeTanabe
GCA_013620965.1	1624	1620	4	4	78	Spathaspora passalidarum NRRL Y-27907 NRRL Y-27907
GCA_013620985.1	1492	1473	19	16	198	Lodderomyces elongisporus NRRL YB-4239 NRRL YB-4239
GCA_013694445.1	1623	1622	1	7	76	Torulaspora sp. CBS 2947 CBS2947
GCA_014049445.1	1604	1590	14	4	98	Candida parapsilosis FDAARGOS_652
GCA_014049455.1	1604	1588	16	5	97	Candida parapsilosis FDAARGOS_651
GCA_014049485.1	1432	1269	163	28	246	Candida albicans FDAARGOS_656
GCA_014049495.1	1608	1596	12	3	95	Candida parapsilosis FDAARGOS_653
GCA_014049585.1	1608	1595	13	5	93	Candida parapsilosis FDAARGOS_650
GCA_014132375.1	1628	1545	83	5	73	Saccharomyces cerevisiae NYR20
GCA_014132395.1	1601	1523	78	9	96	Saccharomyces cerevisiae P-684
GCA_014133895.1	1633	1631	2	7	66	Torulaspora globosa CBS764
GCA_014176175.1	1405	1397	8	29	272	Brettanomyces bruxellensis AWRI1613
GCA_014176185.1	1389	1382	7	27	290	Brettanomyces bruxellensis AWRI1613
GCA_014217455.1	1579	1578	1	9	118	[Candida] auris
GCA_014217725.1	1599	1562	37	5	102	[Candida] glabrata BG2
GCA_014490615.1	1582	1573	9	6	118	Yarrowia lipolytica DSM 3286
GCA_014596635.1	1594	1437	157	10	102	Geotrichum candidum LMA-40
GCA_014636115.1	1602	1599	3	8	96	Clavispora lusitaniae FDAARGOS_655
GCA_014638765.1	1600	1599	1	7	99	[Candida] auris FG_GE10
GCA_014638775.1	1601	1600	1	6	99	[Candida] auris FG_GE9
GCA_014638805.1	1599	1598	1	7	100	[Candida] auris FG_GE8
GCA_014638825.1	1599	1598	1	8	99	[Candida] auris FG_GE7
GCA_014638875.1	1599	1598	1	6	101	[Candida] auris FG_GE6
GCA_014638885.1	1599	1598	1	7	100	[Candida] auris FG_GE5
GCA_014638895.1	1599	1598	1	7	100	[Candida] auris FG_GE4
GCA_014638955.1	1599	1598	1	6	101	[Candida] auris FG_GE2
GCA_014638965.1	1600	1599	1	6	100	[Candida] auris FG_GE3
GCA_014673535.1	1600	1599	1	6	100	[Candida] auris CA-AM1
GCA_014825715.1	409	404	5	339	958	Candida albicans UCSD
GCA_014898825.1	1622	1538	84	5	79	Saccharomyces cerevisiae U-1A-D1628
GCA_014898935.1	1626	1541	85	4	76	Saccharomyces cerevisiae 74-D694
GCA_014905575.1	1629	1553	76	5	72	Saccharomyces cerevisiae Awamori-101
GCA_014905795.1	1454	1383	71	33	219	Metschnikowia persimmonesis KIOM G15050
GCA_015227795.1	1516	1507	9	52	138	Candida albicans ATCC 10231
GCA_015251375.1	1617	1536	81	5	84	Saccharomyces cerevisiae Y9_Hap1
GCA_015251845.1	1633	1551	82	4	69	Saccharomyces cerevisiae Y12
GCA_015251875.1	1626	1547	79	7	73	Saccharomyces cerevisiae YPS1009
GCA_015251885.1	1629	1548	81	6	71	Saccharomyces cerevisiae NC-02
GCA_015251915.1	1542	1469	73	39	125	Saccharomyces cerevisiae PW5
GCA_015251945.1	1628	1550	78	4	74	Saccharomyces cerevisiae UC5
GCA_015344825.1	1488	1474	14	73	145	Candida albicans ATCC 18804
GCA_015344855.1	1527	1519	8	56	123	Candida albicans ATCC 90029
GCA_015344875.1	1606	1604	2	3	97	Candida parapsilosis ATCC 22019
GCA_015344895.1	1496	1487	9	72	138	Candida albicans ATCC 38289
GCA_015345605.1	1466	1458	8	93	147	Candida albicans ATCC 76485
GCA_015345665.1	1469	1460	9	92	145	Candida albicans ATCC 96901
GCA_015345685.1	1481	1466	15	81	144	Candida albicans ATCC 28121
GCA_015345725.1	1515	1505	10	58	133	Candida albicans ATCC MYA-1023
GCA_015345785.1	1528	1520	8	50	128	Candida albicans ATCC 90819
GCA_015345795.1	1460	1448	12	84	162	Candida albicans ATCC 11651
GCA_015345815.1	1465	1454	11	92	149	Candida albicans ATCC MYA-574
GCA_015345835.1	1504	1494	10	64	138	Candida albicans ATCC MYA-427
GCA_015363515.1	1629	1544	85	4	73	Saccharomyces cerevisiae HJ
GCA_015708695.1	1602	1594	8	8	96	[Candida] mesenterica UWOPS91-121.2
GCA_015708715.1	1589	1588	1	7	110	Kodamaea ohmeri UWOPS01-666b4
GCA_015708725.1	1591	1590	1	9	106	Kodamaea ohmeri UWOPS05-228.2
GCA_015708755.1	1582	1579	3	13	111	Kodamaea anthophila UWOPS91-893.2
GCA_015708815.1	1579	1576	3	9	118	Kodamaea anthophila UWOPS95-602.1
GCA_016097515.1	1666	1646	20	1	39	Debaryomyces hansenii C0-11-Y2
GCA_016097625.1	1670	1660	10	3	33	Debaryomyces hansenii C0-11-Y2
GCA_016110235.1	1547	1511	36	14	145	Kazachstania unispora IBR014
GCA_016162255.1	1619	1613	6	7	80	Blastobotrys adeninivorans TMCC 70007
GCA_900002835.2	1405	1402	3	56	245	Candida orthopsilosis MCO456
GCA_900004165.1	1602	1600	2	5	99	Candida parapsilosis CBS1954
GCA_900007755.1	1607	1600	7	8	91	Komagataella pastoris
GCA_900007765.1	1606	1599	7	8	92	Komagataella pastoris
GCA_900009515.1	1605	1597	8	8	93	Komagataella pastoris
GCA_900009525.1	1606	1599	7	8	92	Komagataella pastoris
GCA_900010155.1	1608	1601	7	7	91	Komagataella pastoris
GCA_900013415.1	1607	1600	7	8	91	Komagataella pastoris
GCA_900016195.1	1607	1600	7	9	90	Komagataella pastoris
GCA_900016385.1	1608	1600	8	8	90	Komagataella pastoris
GCA_900016395.1	1609	1601	8	8	89	Komagataella pastoris
GCA_900016405.1	1607	1600	7	8	91	Komagataella pastoris
GCA_900016415.1	1607	1600	7	9	90	Komagataella pastoris
GCA_900016425.1	1608	1601	7	8	90	Komagataella pastoris
GCA_900016435.1	1607	1600	7	8	91	Komagataella pastoris
GCA_900016445.1	1609	1601	8	7	90	Komagataella pastoris
GCA_900016455.1	1608	1600	8	8	90	Komagataella pastoris
GCA_900016465.1	1607	1599	8	8	91	Komagataella pastoris
GCA_900016475.1	1610	1602	8	7	89	Komagataella pastoris
GCA_900016485.1	1608	1600	8	8	90	Komagataella pastoris
GCA_900016495.1	1610	1602	8	7	89	Komagataella pastoris
GCA_900016505.1	1608	1600	8	7	91	Komagataella pastoris
GCA_900016515.1	1607	1600	7	8	91	Komagataella pastoris
GCA_900016525.1	1607	1600	7	8	91	Komagataella pastoris
GCA_900016535.1	1606	1599	7	7	93	Komagataella pastoris
GCA_900016545.1	1608	1601	7	8	90	Komagataella pastoris
GCA_900016555.1	1607	1600	7	8	91	Komagataella pastoris
GCA_900016565.1	1609	1601	8	7	90	Komagataella pastoris
GCA_900016575.1	1609	1601	8	8	89	Komagataella pastoris
GCA_900016585.1	1607	1600	7	7	92	Komagataella pastoris
GCA_900016595.1	1607	1600	7	8	91	Komagataella pastoris
GCA_900016605.1	1607	1599	8	8	91	Komagataella pastoris
GCA_900016615.1	1609	1601	8	7	90	Komagataella pastoris
GCA_900069165.1	1599	1585	14	4	103	Candida metapsilosis CANME
GCA_900074715.1	1652	1652	0	5	49	Lachancea meyersii CBS 8951
GCA_900074725.1	1634	1634	0	7	65	Lachancea dasiensis CBS 10888
GCA_900074735.1	1631	1631	0	3	72	Lachancea sp. CBS 6924
GCA_900074745.1	1627	1627	0	7	72	Lachancea mirantina
GCA_900074755.1	1650	1650	0	3	53	Lachancea nothofagi CBS 11611
GCA_900074765.1	1649	1649	0	5	52	Lachancea fermentati
GCA_900087985.1	1584	1572	12	4	118	Yarrowia lipolytica
GCA_900096545.1	1542	1509	33	16	148	[Candida] glabrata
GCA_900099155.1	1609	1547	62	12	85	Saccharomyces cerevisiae
GCA_900099165.1	1610	1548	62	13	83	Saccharomyces cerevisiae
GCA_900099195.1	1615	1549	66	9	82	Saccharomyces cerevisiae
GCA_900099225.1	1611	1543	68	12	83	Saccharomyces cerevisiae
GCA_900099235.1	1609	1547	62	12	85	Saccharomyces cerevisiae
GCA_900099255.1	1612	1552	60	13	81	Saccharomyces cerevisiae
GCA_900099265.1	1608	1548	60	10	88	Saccharomyces cerevisiae
GCA_900099275.1	1619	1555	64	8	79	Saccharomyces cerevisiae
GCA_900099285.1	1619	1553	66	6	81	Saccharomyces cerevisiae
GCA_900099305.1	1622	1555	67	6	78	Saccharomyces cerevisiae
GCA_900099345.1	1613	1546	67	9	84	Saccharomyces cerevisiae
GCA_900099355.1	1614	1546	68	9	83	Saccharomyces cerevisiae
GCA_900099375.1	1619	1554	65	8	79	Saccharomyces cerevisiae
GCA_900099395.1	1625	1549	76	7	74	Saccharomyces cerevisiae
GCA_900099425.1	1622	1554	68	5	79	Saccharomyces cerevisiae
GCA_900099445.1	1622	1553	69	4	80	Saccharomyces cerevisiae
GCA_900106115.1	1603	1602	1	4	99	[Candida] intermedia CBS 141442
GCA_900106125.1	1572	1570	2	13	121	[Candida] intermedia PYCC 4715
GCA_900119595.1	1017	1015	2	16	673	Hanseniaspora guilliermondii UTAD222
GCA_900162805.1	1638	1633	5	5	63	Zygosaccharomyces bailii IST302
GCA_900166875.1	1542	1509	33	16	148	[Candida] glabrata
GCA_900174495.1	1623	1618	5	9	74	Meyerozyma guilliermondii
GCA_900177835.1	1548	1483	65	50	108	Saccharomyces cerevisiae
GCA_900177845.1	1621	1544	77	11	74	Saccharomyces cerevisiae
GCA_900177855.1	1560	1495	65	39	107	Saccharomyces cerevisiae
GCA_900177865.1	1621	1544	77	14	71	Saccharomyces cerevisiae
GCA_900177875.1	1252	1219	33	191	263	Saccharomyces cerevisiae
GCA_900177885.1	1593	1527	66	28	85	Saccharomyces cerevisiae
GCA_900177905.1	1593	1522	71	20	93	Saccharomyces cerevisiae
GCA_900177915.1	1632	1554	78	5	69	Saccharomyces cerevisiae
GCA_900177925.1	1586	1516	70	20	100	Saccharomyces cerevisiae
GCA_900177935.1	1626	1552	74	8	72	Saccharomyces cerevisiae
GCA_900177945.1	1176	1131	45	250	280	Saccharomyces cerevisiae
GCA_900177955.1	409	400	9	412	885	Saccharomyces cerevisiae
GCA_900177965.1	1573	1512	61	21	112	Saccharomyces cerevisiae
GCA_900177975.1	1629	1552	77	7	70	Saccharomyces cerevisiae
GCA_900177985.1	1617	1539	78	12	77	Saccharomyces cerevisiae
GCA_900177995.1	1627	1550	77	5	74	Saccharomyces cerevisiae
GCA_900178015.1	1626	1550	76	6	74	Saccharomyces cerevisiae
GCA_900178025.1	1623	1549	74	9	74	Saccharomyces cerevisiae
GCA_900178035.1	1626	1547	79	7	73	Saccharomyces cerevisiae
GCA_900178045.1	1630	1554	76	6	70	Saccharomyces cerevisiae
GCA_900178065.1	1628	1554	74	6	72	Saccharomyces cerevisiae
GCA_900178075.1	1626	1549	77	6	74	Saccharomyces cerevisiae
GCA_900178105.1	1628	1548	80	7	71	Saccharomyces cerevisiae MCN1500_3C
GCA_900178125.1	1629	1547	82	2	75	Saccharomyces cerevisiae MCN1500_10C
GCA_900178135.1	1621	1550	71	7	78	Saccharomyces cerevisiae MUCL42908
GCA_900178145.1	1609	1538	71	18	79	Saccharomyces cerevisiae CLIB560
GCA_900178155.1	1626	1548	78	7	73	Saccharomyces cerevisiae Lava32_6
GCA_900178165.1	1619	1538	81	9	78	Saccharomyces cerevisiae N15_4
GCA_900178175.1	1624	1551	73	7	75	Saccharomyces cerevisiae NRRY1791
GCA_900178185.1	1584	1514	70	23	99	Saccharomyces cerevisiae 309
GCA_900178195.1	1616	1540	76	8	82	Saccharomyces cerevisiae CLIB215_3B
GCA_900178205.1	1629	1551	78	5	72	Saccharomyces cerevisiae CLIB219
GCA_900178215.1	1628	1548	80	3	75	Saccharomyces cerevisiae ZP611
GCA_900178225.1	1629	1550	79	4	73	Saccharomyces cerevisiae Lava38_1
GCA_900178235.1	1635	1560	75	3	68	Saccharomyces cerevisiae TL229_alpha
GCA_900178245.1	1627	1547	80	5	74	Saccharomyces cerevisiae 390_D2
GCA_900178255.1	1608	1537	71	15	83	Saccharomyces cerevisiae YQ5
GCA_900178265.1	1615	1541	74	6	85	Saccharomyces cerevisiae 6464
GCA_900178275.1	1630	1551	79	6	70	Saccharomyces cerevisiae Lava32_15
GCA_900178285.1	1633	1553	80	3	70	Saccharomyces cerevisiae EDV493
GCA_900178295.1	1626	1550	76	8	72	Saccharomyces cerevisiae MJ73
GCA_900178305.1	1613	1540	73	10	83	Saccharomyces cerevisiae CBS7957
GCA_900178315.1	1625	1547	78	4	77	Saccharomyces cerevisiae 376
GCA_900178325.1	1629	1549	80	3	74	Saccharomyces cerevisiae OakArd11_2_2
GCA_900178335.1	1629	1546	83	5	72	Saccharomyces cerevisiae ZP1050
GCA_900178345.1	1629	1546	83	6	71	Saccharomyces cerevisiae OakRom3_2
GCA_900178355.1	1626	1547	79	7	73	Saccharomyces cerevisiae CBS7959
GCA_900178365.1	1525	1457	68	68	113	Saccharomyces cerevisiae CLIB215
GCA_900178375.1	1626	1546	80	7	73	Saccharomyces cerevisiae ZP851
GCA_900178385.1	1630	1548	82	3	73	Saccharomyces cerevisiae OakBod21_1
GCA_900178395.1	1620	1548	72	9	77	Saccharomyces cerevisiae NRRLY1545
GCA_900178405.1	1627	1548	79	4	75	Saccharomyces cerevisiae OakGri7_1
GCA_900178415.1	1618	1541	77	10	78	Saccharomyces cerevisiae VPDN_Fino
GCA_900178425.1	1604	1527	77	11	91	Saccharomyces cerevisiae CBS1171
GCA_900178435.1	1608	1536	72	15	83	Saccharomyces cerevisiae KS11
GCA_900178445.1	1630	1550	80	3	73	Saccharomyces cerevisiae YA3
GCA_900178455.1	1619	1542	77	9	78	Saccharomyces cerevisiae 460
GCA_900178465.1	1619	1541	78	6	81	Saccharomyces cerevisiae
GCA_900178475.1	1629	1551	78	5	72	Saccharomyces cerevisiae ZP848
GCA_900178485.1	1619	1540	79	12	75	Saccharomyces cerevisiae VKMY373
GCA_900178495.1	1628	1549	79	8	70	Saccharomyces cerevisiae 245
GCA_900178505.1	1625	1545	80	7	74	Saccharomyces cerevisiae M2ONO800_1A
GCA_900180425.1	1587	1528	59	5	114	Kazachstania saulgeensis
GCA_900186055.1	1642	1641	1	5	59	Torulaspora microellipsoides
GCA_900186115.1	1328	1324	4	38	340	Brettanomyces bruxellensis
GCA_900186205.1	1666	1665	1	2	38	[Candida] psychrophila
GCA_900231965.1	1629	1611	18	6	71	Meyerozyma caribbica
GCA_900231995.1	1630	1627	3	5	71	Meyerozyma caribbica
GCA_900232055.1	1628	1626	2	8	70	Meyerozyma caribbica
GCA_900232065.1	1620	1534	86	11	75	Meyerozyma caribbica
GCA_900234805.1	1606	1600	6	8	92	Komagataella phaffii
GCA_900235035.1	1609	1603	6	9	88	Komagataella phaffii CBS 7435
GCA_900290405.1	1622	1546	76	2	82	Saccharomyces jurei
GCA_900408955.1	1639	142	1497	7	60	Zygosaccharomyces pseudobailii
GCA_900411385.1	1636	196	1440	3	67	Zygosaccharomyces rouxii
GCA_900465325.1	1618	335	1283	4	84	Zygosaccharomyces sapae
GCA_900465365.1	1378	1375	3	30	298	[Candida] vartiovaarae
GCA_900491785.1	1331	1330	1	20	355	Saccharomycodes ludwigii UTAD17
GCA_900496985.1	1427	1383	44	21	258	Brettanomyces bruxellensis
GCA_900497715.1	1441	1435	6	15	250	Magnusiomyces ingens NRRL Y-17630
GCA_900497725.1	1514	1509	5	8	184	Magnusiomyces capitatus NRRL Y-17686
GCA_900500645.1	1630	1626	4	9	67	Meyerozyma guilliermondii W2
GCA_900518985.1	1585	1576	9	5	116	Yarrowia alimentaria
GCA_900518995.1	1574	1566	8	6	126	Yarrowia yakushimensis
GCA_900519005.1	1560	1551	9	8	138	Yarrowia phangngaensis
GCA_900519015.1	1583	1575	8	4	119	Yarrowia osloensis
GCA_900519025.1	1589	1582	7	7	110	Yarrowia porcina
GCA_900519035.1	1585	1577	8	9	112	Yarrowia keelungensis
GCA_900519045.1	1582	1574	8	3	121	Yarrowia divulgata
GCA_900519055.1	1571	1563	8	6	129	Yarrowia galli
GCA_900519065.1	1581	1575	6	8	117	Yarrowia hollandica
GCA_900519075.1	1577	1568	9	13	116	Yarrowia bubula
GCA_900519085.1	1582	1573	9	3	121	Yarrowia deformans
GCA_900535975.1	1525	1521	4	14	167	[Candida] hispaniensis
GCA_900537225.1	1583	1575	8	4	119	Yarrowia lipolytica
GCA_900642975.1	1500	1155	345	13	193	Saprochaete suaveolens
GCA_900654225.1	1499	1493	6	12	195	Saprochaete fungicola
GCA_900660285.1	1543	1535	8	5	158	Brettanomyces naardenensis
GCA_900682695.1	1618	1535	83	6	82	Saccharomyces kudriavzevii CR85
GCA_902155815.1	1411	1403	8	25	270	Brettanomyces bruxellensis
GCA_902192245.1	1629	1543	86	5	72	Saccharomyces cerevisiae
GCA_902192255.1	1627	1545	82	4	75	Saccharomyces cerevisiae
GCA_902192265.1	1627	1543	84	5	74	Saccharomyces cerevisiae
GCA_902192275.1	1626	1542	84	8	72	Saccharomyces cerevisiae
GCA_902192285.1	1626	1544	82	3	77	Saccharomyces cerevisiae
GCA_902192295.1	1626	1541	85	6	74	Saccharomyces cerevisiae
GCA_902192305.1	1625	1540	85	7	74	Saccharomyces cerevisiae
GCA_902192315.1	1626	1543	83	6	74	Saccharomyces cerevisiae
GCA_902192325.1	1631	1548	83	3	72	Saccharomyces cerevisiae
GCA_902192335.1	1624	1541	83	5	77	Saccharomyces cerevisiae
GCA_902364165.1	1520	1402	118	22	164	Kluyveromyces marxianus
GCA_902498895.1	1484	1476	8	13	209	Saprochaete ingens
GCA_902703435.1	1598	1597	1	7	101	[Candida] auris
GCA_902703445.1	1600	1599	1	6	100	[Candida] auris
GCA_902703455.1	1598	1597	1	7	101	[Candida] auris
GCA_902703465.1	1598	1597	1	7	101	[Candida] auris
GCA_902703475.1	1598	1597	1	6	102	[Candida] auris
GCA_902703485.1	1598	1597	1	8	100	[Candida] auris
GCA_902703495.1	1598	1597	1	7	101	[Candida] auris
GCA_902703505.1	1598	1597	1	7	101	[Candida] auris
GCA_902703515.1	1597	1596	1	6	103	[Candida] auris
GCA_902703525.1	1598	1597	1	7	101	[Candida] auris
GCA_902703535.1	1599	1598	1	7	100	[Candida] auris
GCA_902703555.1	1598	1597	1	6	102	[Candida] auris
GCA_902703565.1	1599	1598	1	6	101	[Candida] auris
GCA_902703575.1	1598	1597	1	7	101	[Candida] auris
GCA_902703585.1	1599	1598	1	6	101	[Candida] auris
GCA_902703595.1	1597	1596	1	7	102	[Candida] auris
GCA_902703675.1	1598	1597	1	7	101	[Candida] auris
GCA_902703685.1	1598	1597	1	6	102	[Candida] auris
GCA_902703725.1	1599	1598	1	8	99	[Candida] auris
GCA_902703805.1	1597	1596	1	7	102	[Candida] auris
GCA_902703815.1	1599	1598	1	6	101	[Candida] auris
GCA_902703825.1	1597	1596	1	7	102	[Candida] auris
GCA_902703835.1	1599	1598	1	6	101	[Candida] auris
GCA_902712105.3	1508	1507	1	33	165	[Candida] auris
GCA_902712115.3	1596	1571	25	7	103	[Candida] auris
GCA_902712125.3	1481	1481	0	39	186	[Candida] auris
GCA_902712135.3	1594	1574	20	7	105	[Candida] auris
GCA_902712145.3	1590	1538	52	10	106	[Candida] auris
GCA_902712155.3	1594	1575	19	8	104	[Candida] auris
GCA_902712165.3	1600	1599	1	6	100	[Candida] auris
GCA_902712175.3	1585	1560	25	10	111	[Candida] auris
GCA_902712185.3	1565	1447	118	20	121	[Candida] auris
GCA_902712195.3	1597	1587	10	6	103	[Candida] auris
GCA_902712205.3	1597	1558	39	6	103	[Candida] auris
GCA_902712215.3	1442	1442	0	53	211	[Candida] auris
GCA_902712225.3	1508	1507	1	29	169	[Candida] auris
GCA_902712235.3	1442	1442	0	52	212	[Candida] auris
GCA_902712245.3	1530	1529	1	26	150	[Candida] auris
GCA_902712255.3	1431	1430	1	41	234	[Candida] auris
GCA_902712265.3	1599	1598	1	6	101	[Candida] auris
GCA_902712275.3	1513	1513	0	24	169	[Candida] auris
GCA_902712835.3	1479	1477	2	34	193	[Candida] auris
GCF_000002515.2	1610	1607	3	6	90	Kluyveromyces lactis NRRL Y-1140
GCF_000002525.2	1583	1575	8	5	118	Yarrowia lipolytica CLIB122 CLIB122
GCF_000002545.3	1601	1563	38	4	101	[Candida] glabrata CBS 138
GCF_000003835.1	1564	1561	3	18	124	Clavispora lusitaniae ATCC 42720 ATCC 42720
GCF_000006335.3	1593	1582	11	9	104	Candida tropicalis MYA-3404 MYA-3404
GCF_000006445.2	1667	1664	3	2	37	Debaryomyces hansenii CBS767 CBS767
GCF_000026365.1	1631	1628	3	4	71	Zygosaccharomyces rouxii CBS 732
GCF_000026945.1	1615	1607	8	4	87	Candida dubliniensis CD36 CD36
GCF_000027005.1	1594	1590	4	9	103	Komagataella phaffii GS115 GS115
GCF_000091025.4	1581	1579	2	11	114	Eremothecium gossypii ATCC 10895 ATCC 10895
GCF_000142805.1	1638	1637	1	7	61	Lachancea thermotolerans CBS 6340 CBS 6340
GCF_000146045.2	1627	1544	83	5	74	Saccharomyces cerevisiae S288C S288C
GCF_000149425.1	1598	1595	3	14	94	Meyerozyma guilliermondii ATCC 6260 ATCC 6260
GCF_000149685.1	1549	1544	5	14	143	Lodderomyces elongisporus NRRL YB-4239 NRRL YB-4239
GCF_000150035.1	1588	1513	75	8	110	Vanderwaltozyma polyspora DSM 70294 DSM 70294
GCF_000182765.1	1638	83	1555	5	63	Candida parapsilosis CDC317
GCF_000182965.3	1618	1609	9	4	84	Candida albicans SC5314 SC5314
GCF_000187245.1	1565	1563	2	7	134	Ogataea parapolymorpha DL-1 DL-1
GCF_000209165.1	1648	1645	3	2	56	Scheffersomyces stipitis CBS 6054 CBS 6054
GCF_000223465.1	1609	1606	3	2	95	Yamadazyma tenuis ATCC 10573 ATCC 10573
GCF_000223485.1	1627	1623	4	2	77	Spathaspora passalidarum NRRL Y-27907 NRRL Y-27907
GCF_000227115.2	1608	1549	59	4	94	Naumovozyma dairenensis CBS 421 type strain:CBS 421
GCF_000235365.1	1581	1581	0	12	113	Eremothecium cymbalariae DBVPG#7215 DBVPG#7215
GCF_000236905.1	1594	1540	54	4	108	Tetrapisispora phaffii CBS 4417 type strain:CBS 4417
GCF_000237345.1	1618	1530	88	0	88	Naumovozyma castellii CBS 4309 type strain:CBS 4309
GCF_000243375.1	1634	1632	2	4	68	Torulaspora delbrueckii type strain:CBS 1146
GCF_000304475.1	1587	1536	51	5	114	Kazachstania africana CBS 2517 type strain:CBS 2517
GCF_000313485.1	1647	1643	4	4	55	Wickerhamomyces ciferrii NRRL Y-1031 F-60-10
GCF_000315875.1	1609	1607	2	4	93	Candida orthopsilosis Co 90-125 Co 90-125
GCF_000315915.1	1534	1494	40	7	165	Tetrapisispora blattae CBS 6284 type strain:CBS 6284
GCF_000348985.1	1570	1517	53	7	129	Kazachstania naganishii CBS 8797 type strain:CBS 8797
GCF_000576695.1	1604	1601	3	6	96	Kuraishia capsulata CBS 1993 CBS 1993
GCF_000938715.1	1638	1637	1	7	61	Lachancea lanzarotensis CBS 12615
GCF_001298625.1	1626	1543	83	5	75	Saccharomyces eubayanus FM1318
GCF_001417885.1	1616	1614	2	8	82	Kluyveromyces marxianus DMKU3-1042 DMKU3-1042
GCF_001447935.2	1653	1648	5	7	46	Debaryomyces fabryi CBS 789
GCF_001640025.1	1600	1595	5	11	95	Sugiyamaella lignohabitans CBS 10342
GCF_001661235.1	1474	1472	2	15	217	Pichia membranifaciens NRRL Y-2026 NRRL Y-2026
GCF_001661255.1	1628	1622	6	6	72	Wickerhamomyces anomalus NRRL Y-366-8 NRRL Y-366-8
GCF_001661335.1	1618	1613	5	8	80	Babjeviella inositovora NRRL Y-12698 NRRL Y-12698
GCF_001661345.1	1488	1463	25	12	206	Ascoidea rubescens DSM 1968 DSM 1968
GCF_001661395.1	1644	1640	4	4	58	Hyphopichia burtonii NRRL Y-1933 NRRL Y-1933
GCF_001661405.1	1628	1606	22	5	73	Cyberlindnera jadinii NRRL Y-1542 NRRL Y-1542
GCF_001661415.1	1650	1647	3	6	50	Suhomyces tanzawaensis NRRL Y-17324 NRRL Y-17324
GCF_001664035.1	1568	1564	4	13	125	Metschnikowia bicuspidata var. bicuspidata NRRL YB-4993 NRRL YB-4993
GCF_001664045.1	1567	1564	3	5	134	Ogataea polymorpha NCYC 495 leu1.1
GCF_002079055.1	1627	1544	83	4	75	Saccharomyces paradoxus CBS432
GCF_002251995.1	1425	1419	6	13	268	Wickerhamiella sorbophila DS02
GCF_002775015.1	1591	1586	5	7	108	[Candida] auris B11221
GCF_002926055.2	1575	1574	1	9	122	[Candida] haemuloni B11899
GCF_002926085.2	1534	1531	3	9	163	[Candida] duobushaemulonis B09383
GCF_003013735.1	1585	1583	2	12	109	[Candida] pseudohaemulonis B12108
GCF_003054445.1	1436	1432	4	14	256	Pichia kudriavzevii CBS573
GCF_008704595.1	1466	1463	3	17	223	Diutina rugosa CBS 613
GCF_013402915.1	1644	62	1582	10	52	Zygotorulaspora mrakii NRRL Y-6702
GCF_014133895.1	1657	80	1577	4	45	Torulaspora globosa CBS764
GCF_902498895.1	1484	1476	8	13	209	Saprochaete ingens
